Item ID,High Price,Low Price,Margin,High Time,Low Time
2,207,201,6,1728565996,1728565899
6,197440,197440,0,1728563426,1728565461
8,183827,183827,0,1728564484,1728565467
10,191985,183658,8327,1728565734,1728565480
12,291020,205712,85308,1728562976,1728565464
28,300,93,207,1728563773,1728547257
30,950,921,29,1728565993,1728565317
36,224,225,-1,1728565907,1728565304
39,2,4,-2,1728565995,1728560423
40,5,4,1,1728565977,1728565933
41,19,18,1,1728565807,1728564368
42,32,31,1,1728565835,1728564315
43,95,94,1,1728565483,1728565006
44,221,221,0,1728565738,1728565517
45,76,30,46,1728559099,1728561449
46,62,55,7,1728565300,1728563129
47,72,75,-3,1728565754,1728564107
48,15,15,0,1728563775,1728565696
50,27,27,0,1728563736,1728565049
52,1,1,0,1728565977,1728562148
53,10,9,1,1728565906,1728565929
54,37,34,3,1728564843,1728564891
56,24,17,7,1728561233,1728564769
58,58,51,7,1728565480,1728564378
60,45,40,5,1728556228,1728565303
62,115,112,3,1728565791,1728564452
64,89,89,0,1728565296,1728557183
66,330,314,16,1728565595,1728565811
68,180,171,9,1728563955,1728563578
70,1082,1074,8,1728565226,1728565501
72,832,810,22,1728564899,1728564619
91,399,357,42,1728565876,1728565775
93,241,250,-9,1728565948,1728560536
95,376,395,-19,1728565949,1728565862
97,739,723,16,1728565926,1728565185
99,7200,7180,20,1728565878,1728565996
101,1687,1652,35,1728565075,1728565884
103,4030,4005,25,1728565895,1728565906
105,4039,4007,32,1728565880,1728565918
107,4036,3970,66,1728564722,1728563092
109,2619,2585,34,1728563131,1728565201
111,3135,3014,121,1728565381,1728565389
113,133,129,4,1728565977,1728565691
115,64,62,2,1728563072,1728562394
117,60,61,-1,1728536985,1728564651
119,72,35,37,1728541260,1728565672
121,4,4,0,1728559984,1728565632
123,7,5,2,1728565979,1728564732
125,5,10,-5,1728508547,1728565744
127,49,67,-18,1728560867,1728565293
129,10,10,0,1728537144,1728555882
131,16,28,-12,1728441188,1728556204
133,999,401,598,1728548201,1728565713
135,217,170,47,1728518877,1728556368
137,16,10,6,1728551555,1728559104
139,7216,7216,0,1728565865,1728565946
141,4808,4780,28,1728565700,1728565942
143,2413,2350,63,1728564583,1728565940
145,1142,1112,30,1728562906,1728565997
147,578,580,-2,1728558283,1728564354
149,323,335,-12,1728563073,1728563693
151,34,34,0,1728561619,1728557659
153,40,2094,-2054,1728554841,1728428884
155,10000,33,9967,1728410057,1728540454
157,3956,3936,20,1728565328,1728566001
159,2447,2445,2,1728548616,1728565556
161,1294,1221,73,1728562856,1728564516
163,3954,3970,-16,1728565378,1728565478
165,2583,2027,556,1728562688,1728565593
167,1125,1036,89,1728559409,1728565852
169,1996,1851,145,1728564965,1728565916
171,1233,1231,2,1728565594,1728562949
173,763,727,36,1728564694,1728565546
175,112,110,2,1728563772,1728564821
177,78,54,24,1728561108,1728564284
179,155,53,102,1728561687,1728565991
181,800,777,23,1728565678,1728565809
183,532,509,23,1728565017,1728565920
185,500,406,94,1728565579,1728565631
187,266,266,0,1728559009,1728565913
189,1070,1002,68,1728563064,1728565825
191,320,310,10,1728529823,1728561158
193,253,300,-47,1728552827,1728518735
197,3000,1326,1674,1728553385,1728500223
199,237,233,4,1728565919,1728565944
201,223,217,6,1728565811,1728565992
203,305,275,30,1728565580,1728565991
205,611,610,1,1728565783,1728565996
207,6941,6901,40,1728565958,1728566001
209,1500,1497,3,1728565897,1728565939
211,3815,3800,15,1728565813,1728565998
213,3874,3706,168,1728565713,1728565981
215,3976,3857,119,1728565938,1728565988
217,2323,2319,4,1728565980,1728566001
219,3141,3140,1,1728565833,1728565985
221,4,4,0,1728565821,1728565829
223,387,381,6,1728565964,1728565974
225,653,653,0,1728565960,1728565982
227,4,4,0,1728565986,1728565866
229,2,2,0,1728566001,1728566001
231,422,414,8,1728565983,1728565854
233,135,105,30,1728565833,1728563639
235,551,83,468,1728565933,1728565624
237,528,521,7,1728565924,1728565895
239,924,885,39,1728565973,1728565989
241,72,72,0,1728565461,1728562970
243,20,15,5,1728565435,1728564840
245,820,819,1,1728565979,1728565976
247,397,346,51,1728565952,1728565080
249,237,230,7,1728565923,1728565808
251,290,290,0,1728565966,1728565983
253,330,315,15,1728565870,1728565963
255,640,621,19,1728565801,1728565870
257,6950,6912,38,1728565524,1728565951
259,1545,1521,24,1728565975,1728565988
261,3815,3767,48,1728565809,1728565877
263,3750,3723,27,1728565913,1728565970
265,3886,3876,10,1728565638,1728565929
267,2400,2400,0,1728565974,1728565925
269,3197,3164,33,1728565943,1728565946
272,990,555,435,1728565592,1728555591
273,650,632,18,1728565551,1728565184
288,900,755,145,1728566001,1728565728
299,1464,1455,9,1728565487,1728565841
301,227,180,47,1728565944,1728565693
303,380,353,27,1728565984,1728565398
305,602,493,109,1728565540,1728564886
307,400,375,25,1728565980,1728564466
309,299,289,10,1728565975,1728565815
311,207,131,76,1728565921,1728564318
313,5,4,1,1728565733,1728565840
314,3,2,1,1728565954,1728565923
315,27,27,0,1728565751,1728565951
317,108,108,0,1728565872,1728565901
319,63,62,1,1728565284,1728565975
321,51,50,1,1728565465,1728565671
325,32,31,1,1728564025,1728565704
327,110,103,7,1728565698,1728565090
329,84,84,0,1728565914,1728565764
331,71,70,1,1728565970,1728565961
333,39,39,0,1728565939,1728565805
335,89,80,9,1728565985,1728565675
339,14,13,1,1728557995,1728565694
341,28,28,0,1728565689,1728565882
345,128,121,7,1728565887,1728565807
347,48,44,4,1728561203,1728565754
349,136,125,11,1728565802,1728565857
351,52,32,20,1728565481,1728565577
353,58,22,36,1728565962,1728565858
355,28,22,6,1728559084,1728564963
359,65,60,5,1728565962,1728565824
361,112,111,1,1728565660,1728565717
363,18,16,2,1728565956,1728565848
365,199,150,49,1728565995,1728565759
371,99,96,3,1728566001,1728565842
373,170,163,7,1728565821,1728565862
377,76,75,1,1728565780,1728565951
379,174,173,1,1728565701,1728565920
383,628,626,2,1728565939,1728565975
385,937,920,17,1728565995,1728565995
389,1762,1751,11,1728565794,1728565851
391,2099,2088,11,1728565983,1728565986
395,985,951,34,1728565648,1728565987
397,1351,1275,76,1728565667,1728565952
401,20,16,4,1728565685,1728565982
403,101,53,48,1728565618,1728560951
405,2000,2306,-306,1728562476,1728565632
407,78,77,1,1728565629,1728565377
411,65,65,0,1728561462,1728565537
413,1345,1126,219,1728532871,1728565388
426,292,40,252,1728565982,1728564926
428,165,12,153,1728565990,1728564930
434,90,88,2,1728565991,1728565840
436,29,29,0,1728566001,1728565895
438,31,30,1,1728565915,1728565471
440,255,249,6,1728565927,1728565925
442,61,60,1,1728565926,1728565993
444,168,167,1,1728565993,1728565968
447,141,138,3,1728565981,1728565950
449,937,925,12,1728565809,1728565969
451,11200,11060,140,1728565853,1728565991
453,142,140,2,1728566001,1728566000
464,700,677,23,1728563874,1728565566
526,118,114,4,1728565992,1728565852
528,326,100,226,1728564453,1728518395
530,484,455,29,1728565945,1728561537
532,350,347,3,1728565607,1728565998
534,1135,1002,133,1728565289,1728565350
536,4102,4094,8,1728565966,1728565982
538,19500,1111,18389,1728527455,1728547643
540,8900,1234,7666,1728527510,1728547655
542,596,318,278,1728565951,1728565821
544,784,712,72,1728565941,1728565598
546,2447,1200,1247,1728564854,1728565659
548,650,200,450,1728565989,1728547571
554,5,4,1,1728565991,1728565802
555,5,4,1,1728565972,1728565792
556,5,4,1,1728565996,1728565904
557,5,4,1,1728565989,1728565910
558,4,3,1,1728565962,1728565901
559,11,9,2,1728565918,1728565797
560,158,157,1,1728565996,1728565994
561,113,111,2,1728565999,1728565983
562,106,104,2,1728565994,1728565997
563,158,155,3,1728565978,1728565990
564,130,125,5,1728565998,1728565915
565,302,297,5,1728565898,1728565952
566,187,183,4,1728565996,1728565926
567,79,77,2,1728565999,1728565673
569,1076,1072,4,1728565985,1728565962
571,706,695,11,1728565991,1728565913
573,1226,1216,10,1728565992,1728565890
575,770,770,0,1728565897,1728565906
577,2022,1801,221,1728565943,1728565502
579,209,219,-10,1728565397,1728565972
581,1670,1558,112,1728563708,1728565759
590,100,80,20,1728565947,1728565979
592,92,92,0,1728565855,1728565779
596,2,2,0,1728565789,1728563245
621,216,216,0,1728479176,1728479175
626,1699,1061,638,1728565448,1728560346
628,3994,3000,994,1728564586,1728564803
630,1651,150,1501,1728565708,1728565472
632,800,420,380,1728537333,1728561441
634,1340,751,589,1728565107,1728549567
636,882,400,482,1728564731,1728563773
638,5000,5000,0,1728564567,1728565707
640,1084,1084,0,1728563714,1728529157
642,769,769,0,1728565819,1728556860
644,993,150,843,1728564350,1728555044
646,225,215,10,1728435063,1728518235
648,4999,1000,3999,1728563919,1728563476
650,4999,631,4368,1728405937,1728563862
652,174,223,-49,1728443223,1728528196
654,1024,3000,-1976,1728562806,1728562191
656,1500,1361,139,1728555609,1728554488
658,1130,150,980,1728565812,1728563523
660,614,749,-135,1728556993,1728563642
662,1293,1069,224,1728565950,1728563441
664,950,500,450,1728553899,1728548106
751,28321,28191,130,1728545950,1728564009
753,173,157,16,1728565918,1728565795
800,500,3,497,1728332848,1727616033
801,29,8,21,1727924756,1727630755
802,5,1,4,1728490063,1727741761
803,200,200,0,1727066249,1728270002
804,9000,315,8685,1728518524,1727863197
805,230,221,9,1728565909,1728565969
806,26,27,-1,1728562640,1728565044
807,30,27,3,1728565888,1728565997
808,4,2,2,1728565460,1728564226
809,7,5,2,1728565994,1728565581
810,19,18,1,1728565822,1728565749
811,170,170,0,1728565953,1728565930
812,4000,50,3950,1727599744,1727599804
813,4997,55,4942,1727702045,1727377756
814,1,45,-44,1728087322,1727382945
815,162,5,157,1728481380,1728435787
816,30,30,0,1728562168,1728564191
817,158,158,0,1728559633,1728565522
819,35,33,2,1728563118,1728562739
820,47,48,-1,1728564735,1728565617
821,63,63,0,1728565984,1728565919
822,93,90,3,1728565937,1728565243
823,192,192,0,1728565943,1728564182
824,1137,1126,11,1728565914,1728565996
825,21,21,0,1728562887,1728565707
826,4,5,-1,1728558374,1728534709
827,45,2,43,1728523384,1728553568
828,14,14,0,1728564373,1728565240
829,39,44,-5,1728551999,1728565878
830,200,190,10,1728563488,1728565982
831,45000,50000,-5000,1725498434,1725498620
832,1,1,0,1727793385,1727213155
833,42,1000,-958,1727722749,1720616287
834,10,44,-34,1724984759,1723586115
835,193,2,191,1728324632,1723503923
836,441,538,-97,1728420991,1728480983
837,84,55,29,1728563809,1728551741
839,127,37,90,1728565985,1728565463
841,78,54,24,1728565849,1728565632
843,40,37,3,1728564216,1728565485
845,60,56,4,1728565978,1728565702
847,129,128,1,1728563744,1728565400
849,65,62,3,1728565968,1728565418
851,280,276,4,1728565756,1728565690
853,202,202,0,1728565822,1728565802
855,525,525,0,1728565814,1728565935
857,384,375,9,1728565950,1728565289
859,1287,1265,22,1728565311,1728566000
861,837,816,21,1728565965,1728565637
863,55,37,18,1728563351,1728565896
864,58,52,6,1728565437,1728560017
865,22,22,0,1728564694,1728565780
866,168,128,40,1728565352,1728564447
867,375,282,93,1728565804,1728565692
868,116,114,2,1728565452,1728565761
869,46,45,1,1728565910,1728564132
870,150,16000,-15850,1728440680,1728416956
871,209,78888,-78679,1728444714,1728439912
872,150,217,-67,1728140989,1720667878
873,285,2,283,1728440655,1728140874
874,189,292,-103,1728329330,1728199774
875,626,11,615,1728226390,1728072639
876,338,571,-233,1728539979,1728540017
877,4,4,0,1728565937,1728565770
878,1,80,-79,1728431492,1728263825
879,72,72,0,1728563302,1728546230
880,89,80,9,1728565087,1728565964
881,90,100,-10,1728532513,1728565934
882,3,3,0,1728565965,1728565809
883,49,71,-22,1728451614,1727141519
884,6,7,-1,1728565558,1728565934
885,1000,52,948,1728246535,1728413932
886,19,21,-2,1728565651,1728566000
887,75,101,-26,1728308230,1728319179
888,4,4,0,1728565701,1728565837
889,50000,145,49855,1728212207,1728511203
890,12,11,1,1728565973,1728565900
891,113,549,-436,1728460995,1728382449
892,64,60,4,1728566001,1728565994
893,209,40,169,1728565446,1728525902
946,46,35,11,1728565928,1728565979
948,169,137,32,1728565575,1728564639
950,57,75,-18,1728565584,1728565942
952,156,151,5,1728565994,1728565914
954,90,86,4,1728565967,1728565363
958,29,23,6,1728563505,1728554438
960,325,325,0,1728565987,1728565859
962,330250,330250,0,1728561672,1728561672
970,599,574,25,1728565885,1728565967
973,213,208,5,1728565946,1728565962
975,532,472,60,1728565924,1728565865
981,15000,10500,4500,1728553586,1728562563
983,450,400,50,1728565884,1728562586
985,10800,10800,0,1728565860,1728565986
987,11104,12121,-1017,1728563825,1728565963
989,23012,22854,158,1728564922,1728565956
991,6636,5508,1128,1728565959,1728561423
993,32622,30026,2596,1728513961,1728565588
1005,93,82,11,1728565975,1728565324
1007,156,101,55,1728564456,1728565321
1009,192,183,9,1728530923,1728565507
1011,210,140,70,1728564344,1728565335
1013,315,140,175,1728565596,1728565329
1015,92,20,72,1728563734,1728562910
1017,871,620,251,1728565881,1728565977
1019,700,258,442,1728565975,1728565777
1021,207,126,81,1728565141,1728565912
1023,269,168,101,1728565223,1728547285
1025,175,171,4,1728555212,1728562652
1027,688,233,455,1728564350,1728563733
1029,1392,1069,323,1728539826,1728556063
1031,1548,979,569,1728563593,1728563603
1033,2319,2000,319,1728565846,1728565805
1035,192,522,-330,1728565058,1728565937
1038,8990,8000,990,1728562859,1728565815
1040,5999,5555,444,1728565040,1728565486
1042,33000,28016,4984,1728562894,1728565466
1044,20000,13377,6623,1728562881,1728565882
1046,11111,10877,234,1728562874,1728565885
1048,4999,4217,782,1728563794,1728565988
1050,14750,14021,729,1728565680,1728565490
1053,9548,11052,-1504,1728540435,1728565525
1055,10499,10120,379,1728562395,1728565530
1057,10950,10403,547,1728564495,1728565675
1059,2,2,0,1728565907,1728565770
1061,31,46,-15,1728565269,1728565607
1063,33,15,18,1728565393,1728565772
1065,1419,1370,49,1728565823,1728565937
1067,102,100,2,1728565597,1728565600
1069,425,380,45,1728565967,1728565686
1071,1480,1352,128,1728565805,1728565626
1073,3505,3500,5,1728565978,1728565979
1075,61,89,-28,1728565730,1728562945
1077,1036,1015,21,1728565799,1728565319
1079,37955,37932,23,1728565967,1728565992
1081,450,54,396,1728565249,1728563949
1083,337,337,0,1728564338,1728565800
1085,1307,1200,107,1728565578,1728565955
1087,27,56,-29,1728511443,1728562132
1089,1074,1060,14,1728557953,1728565459
1091,4500,3597,903,1728565754,1728565809
1093,38023,38050,-27,1728565875,1728565985
1095,1,1,0,1728565970,1728556231
1097,239,50,189,1728565984,1728565294
1099,2222,2171,51,1728565932,1728565995
1101,72,65,7,1728565973,1728564345
1103,60,55,5,1728562581,1728565223
1105,278,250,28,1728565946,1728565367
1107,2548,2427,121,1728562903,1728565654
1109,1173,1030,143,1728564530,1728565947
1111,2929,2700,229,1728565923,1728565854
1113,29602,29567,35,1728565879,1728566001
1115,120,100,20,1728565948,1728565833
1117,77,75,2,1728565559,1728565299
1119,969,900,69,1728565929,1728565720
1121,2877,2800,77,1728565553,1728565669
1123,9666,9600,66,1728565991,1728565993
1125,2784,2155,629,1728565949,1728565316
1127,39068,38600,468,1728565890,1728565998
1129,75,14,61,1728565857,1728565639
1131,15,11,4,1728565720,1728565787
1133,399,365,34,1728565596,1728565634
1135,4363,4352,11,1728565940,1728565988
1137,400,50,350,1728565578,1728564256
1139,108,101,7,1728565992,1728565971
1141,96,80,16,1728565935,1728563028
1143,325,300,25,1728565872,1728563664
1145,1176,1000,176,1728565556,1728565951
1147,11103,11103,0,1728565421,1728565995
1149,58810,58848,-38,1728565930,1728565959
1151,352,350,2,1728547802,1728564507
1153,249,100,149,1728565176,1728565811
1155,39,24,15,1728564324,1728563418
1157,117,116,1,1728565936,1728565461
1159,623,600,23,1728565562,1728565290
1161,1900,1800,100,1728565939,1728565959
1163,20691,20701,-10,1728565977,1728565999
1165,706,645,61,1728565856,1728565792
1167,11,11,0,1728565782,1728565522
1169,38,36,2,1728565869,1728565944
1171,104,91,13,1728564148,1728565647
1173,130,55,75,1728565372,1728565805
1175,132,33,99,1728565827,1728560654
1177,199,162,37,1728562599,1728565059
1179,467,490,-23,1728560767,1728565972
1181,701,750,-49,1728565293,1728565817
1183,2001,2000,1,1728565142,1728565661
1185,22578,22564,14,1728565710,1728565891
1187,306500,299400,7100,1728565736,1728565954
1189,112,73,39,1728562358,1728565396
1191,100,89,11,1728565969,1728565817
1193,359,300,59,1728565827,1728565966
1195,1276,1276,0,1728565506,1728565819
1197,1071,1041,30,1728565697,1728565665
1199,3328,3201,127,1728565875,1728565899
1201,32190,32102,88,1728565936,1728565993
1203,101,101,0,1728565637,1728566001
1205,76,5,71,1728565144,1728564542
1207,350,103,247,1728565735,1728565468
1209,152,139,13,1728560160,1728560152
1211,248,243,5,1728565579,1728565803
1213,4555,4428,127,1728565553,1728565994
1215,17491,17489,2,1728565772,1728565952
1217,482,316,166,1728565046,1728565323
1219,50,106,-56,1728483290,1727144261
1221,249,230,19,1724343924,1725580576
1223,295,365,-70,1727485137,1719765736
1225,1,65,-64,1728555248,1727468186
1227,425,60,365,1728289238,1728460969
1229,5631,5631,0,1728405129,1728534331
1231,17811,15550,2261,1728564420,1728563831
1233,101,101,0,1728319495,1728564584
1237,900,870,30,1728565781,1728565402
1239,711,708,3,1728565791,1728565391
1241,128,114,14,1728558642,1728564799
1243,332,327,5,1728555501,1728565859
1245,1100,964,136,1728565707,1728565740
1247,12294,11915,379,1728565846,1728565869
1249,38956,38090,866,1728565792,1728565953
1251,288,5,283,1728493468,1727353230
1253,1170,105,1065,1728022155,1728407201
1255,42,42,0,1728529174,1728543278
1257,237,262,-25,1728548742,1728366472
1259,818,818,0,1728564023,1728564023
1261,13000,13000,0,1727405150,1728030888
1263,42999,35200,7799,1728523715,1728541281
1265,50,25,25,1728565735,1728565763
1267,101,100,1,1728565751,1728565455
1269,427,425,2,1728565398,1728565645
1271,1632,1550,82,1728565960,1728565783
1273,571,555,16,1728565942,1728565861
1275,18717,18711,6,1728565761,1728565988
1277,80,55,25,1728565696,1728565988
1279,200,55,145,1728564536,1728561722
1281,61,41,20,1728565837,1728563453
1283,301,300,1,1728557775,1728565155
1285,416,300,116,1728551123,1728565855
1287,919,967,-48,1728564755,1728565060
1289,12376,12051,325,1728563737,1728565890
1291,51,50,1,1728560147,1728564304
1293,195,65,130,1728565172,1728565274
1295,240,150,90,1728565979,1728565832
1297,367,370,-3,1728521952,1728565604
1299,484,484,0,1728565829,1728565823
1301,1505,1500,5,1728565220,1728565780
1303,18765,18765,0,1728566001,1728566001
1305,59448,59781,-333,1728565951,1728565992
1307,245,88,157,1728565921,1728559415
1309,150,52,98,1728565620,1728561200
1311,322,666,-344,1728539824,1728565838
1313,1040,1050,-10,1728535911,1728565668
1315,1230,1200,30,1728564831,1728564339
1317,3545,3502,43,1728565946,1728565813
1319,38012,38001,11,1728566000,1728565985
1321,145,80,65,1728558164,1728562958
1323,259,54,205,1728564440,1728565964
1325,168,80,88,1728565688,1728563976
1327,1985,1708,277,1728565677,1728564925
1329,343,335,8,1728565899,1728565292
1331,1309,1449,-140,1728565909,1728565971
1333,15150,14953,197,1728565998,1728565963
1335,44,10,34,1728565584,1728565968
1337,88,50,38,1728563755,1728564689
1339,336,254,82,1728565809,1728562454
1341,10000,667,9333,1728564449,1728565901
1343,769,755,14,1728564261,1728565493
1345,2981,2904,77,1728561963,1728565953
1347,24776,24700,76,1728565984,1728565982
1349,199,52,147,1728565832,1728565866
1351,75,50,25,1728565949,1728565431
1353,228,208,20,1728563930,1728565466
1355,88,82,6,1728565910,1728565884
1357,876,463,413,1728565282,1728565973
1359,7567,7228,339,1728565774,1728565993
1361,950,955,-5,1728565231,1728565415
1363,99,40,59,1728527627,1728564727
1365,188,200,-12,1728542198,1728565633
1367,493,495,-2,1728529964,1728565978
1369,995,950,45,1728562958,1728565908
1371,2529,2475,54,1728565524,1728565991
1373,24527,24527,0,1728565824,1728565994
1375,57,55,2,1728549288,1728565288
1377,121500,119561,1939,1728565788,1728565962
1379,200,100,100,1728565584,1728565008
1381,2104,1725,379,1728565893,1728565946
1383,2000,1750,250,1728565817,1728565059
1385,824,822,2,1728565999,1728565601
1387,1225,1206,19,1728565647,1728565885
1389,600,565,35,1728565999,1728565978
1391,8376,8315,61,1728565920,1728565994
1393,9026,9003,23,1728565891,1728565893
1395,9020,9020,0,1728565793,1728565793
1397,9025,8955,70,1728565983,1728565944
1399,9023,9023,0,1728565989,1728565986
1401,25331,25200,131,1728565998,1728565863
1403,25254,25050,204,1728565405,1728565998
1405,25193,25177,16,1728565903,1728565765
1407,25197,25159,38,1728565059,1728565863
1420,63,15,48,1728564506,1728565093
1422,60,51,9,1728562074,1728564894
1424,250,105,145,1728565932,1728563514
1426,919,759,160,1728565504,1728559824
1428,117,120,-3,1728561823,1728564482
1430,603,887,-284,1728558733,1728565336
1432,8295,8189,106,1728565780,1728565899
1434,29430,29401,29,1728565271,1728565934
1436,11,9,2,1728565967,1728564457
1438,82,75,7,1728565915,1728565745
1440,186,181,5,1728566001,1728565988
1442,2095,2022,73,1728565969,1728565979
1444,127,130,-3,1728565922,1728565797
1446,2300,2200,100,1728565944,1728565975
1448,1165,1067,98,1728565746,1728565826
1450,304000,300000,4000,1728563951,1728531471
1452,600,450,150,1728565903,1728565795
1454,204,202,2,1728564285,1728565971
1456,17637,15825,1812,1728565161,1728565923
1462,293,293,0,1728565786,1728565786
1464,15,13,2,1728559460,1728564916
1470,1571,1158,413,1728565993,1728563836
1472,1819,1677,142,1728565980,1728565152
1474,1197,1197,0,1728565934,1728564381
1476,2538,2500,38,1728565963,1728565940
1478,3869,1565,2304,1728558663,1728565881
1511,78,78,0,1728565984,1728565878
1513,1111,1095,16,1728565999,1728565984
1515,263,259,4,1728565909,1728565990
1517,20,17,3,1728565980,1728565994
1519,94,89,5,1728565998,1728565982
1521,114,112,2,1728565970,1728565982
1523,344,198,146,1728565913,1728564005
1539,19,16,3,1728565981,1728565969
1540,200,195,5,1728565403,1728565858
1550,59,56,3,1728565881,1728565207
1552,778,778,0,1728563173,1728543736
1573,6500,300,6200,1728565565,1728564132
1592,382,299,83,1728565719,1728565833
1595,50,75,-25,1728565706,1728561402
1597,577,535,42,1728565731,1728565607
1599,230,60,170,1728565235,1728535464
1601,1677,1662,15,1728565946,1728565978
1603,797,784,13,1728565830,1728565991
1605,392,385,7,1728566001,1728565998
1607,214,213,1,1728565976,1728565997
1609,804,800,4,1728565897,1728565584
1611,293,290,3,1728565991,1728565891
1613,2449,2405,44,1728565909,1728565579
1615,11500,11350,150,1728565948,1728565999
1617,2277,2250,27,1728565991,1728565998
1619,962,963,-1,1728565912,1728565958
1621,440,433,7,1728565806,1728565993
1623,230,230,0,1728565977,1728565976
1625,370,365,5,1728565400,1728565909
1627,165,165,0,1728562238,1728565940
1629,1863,1863,0,1728565956,1728565886
1631,16006,15888,118,1728565634,1728565931
1635,160,159,1,1728565798,1728565997
1637,480,471,9,1728565944,1728565979
1639,650,647,3,1728565585,1728565999
1641,1018,1014,4,1728564733,1728565995
1643,1937,1900,37,1728565718,1728565990
1645,11777,11777,0,1728565902,1728565997
1654,186,180,6,1728565790,1728565884
1656,499,488,11,1728565586,1728565929
1658,683,680,3,1728565468,1728565973
1660,1097,1091,6,1728565979,1728565932
1662,1983,1980,3,1728565873,1728565684
1664,11129,10851,278,1728564829,1728565807
1673,193,170,23,1728555789,1728565857
1675,418,418,0,1728563055,1728551821
1677,650,637,13,1728556111,1728546643
1679,1067,1067,0,1728534051,1728565204
1681,1898,1910,-12,1728564938,1728565991
1683,11329,10638,691,1728564279,1728565920
1692,138,137,1,1728563979,1728565889
1694,649,583,66,1728565164,1728565900
1696,882,840,42,1728565956,1728565895
1698,1265,1250,15,1728565812,1728565910
1700,2169,2120,49,1728565561,1728565983
1702,11602,11175,427,1728565832,1728565522
1704,12000,11955,45,1728565999,1728565995
1712,12198,11933,265,1728565792,1728565841
1714,79,77,2,1728533731,1728533864
1716,82,82,0,1728554308,1728564165
1718,697,665,32,1728565937,1728565936
1720,159,10,149,1728534667,1727425853
1722,30,2,28,1728440782,1727150458
1724,185,185,0,1728563599,1728565952
1725,1600,1446,154,1728565893,1728565952
1727,747,731,16,1728565919,1728565985
1729,1148,1050,98,1728565513,1728565761
1731,2444,2350,94,1728565774,1728565998
1733,18,15,3,1728565980,1728565987
1734,11,11,0,1728565991,1728565991
1735,100,95,5,1728565284,1728565592
1737,229,192,37,1728565818,1728564061
1739,195,200,-5,1728565904,1728565593
1741,400,377,23,1728565900,1728565981
1743,295,275,20,1728565928,1728565805
1745,1673,1649,24,1728565950,1728565828
1747,5301,5088,213,1728565798,1728565995
1749,3080,3069,11,1728566001,1728565961
1751,1971,1951,20,1728565339,1728565980
1753,1478,1453,25,1728565826,1728565998
1755,81,70,11,1728565931,1728565924
1757,999,205,794,1728565654,1728565832
1759,56,56,0,1728565973,1728565974
1761,85,99,-14,1728565965,1728565902
1763,450,447,3,1728565944,1728565632
1765,406,315,91,1728565966,1728562027
1767,250,200,50,1728565929,1728563562
1769,884,875,9,1728565972,1728565726
1771,750,750,0,1728565677,1728553291
1773,750,647,103,1728565950,1728562467
1775,95,94,1,1728565974,1728565865
1777,73,70,3,1728565994,1728564313
1779,2,2,0,1728565995,1728565922
1781,35,20,15,1728550588,1728565038
1783,21,21,0,1728565789,1728565929
1785,13,4,9,1728565956,1728554553
1787,95,15,80,1728527223,1728350439
1789,167,167,0,1728435863,1728431216
1791,173,173,0,1728565281,1728565264
1793,29,27,2,1728565767,1728565787
1794,283,263,20,1728565964,1728565314
1823,167,161,6,1728565876,1728565717
1831,55,39,16,1728564763,1728565909
1833,115,17,98,1728565837,1728565945
1835,889,750,139,1728565819,1728565949
1837,50,7,43,1728565829,1728565941
1854,44,30,14,1728565632,1728565913
1859,1000,250,750,1728564366,1728523023
1861,835,1228,-393,1728505419,1728550782
1865,499,79,420,1728425278,1728524183
1869,999,1000,-1,1727994619,1726940474
1871,37,25,12,1728533533,1728368723
1873,25555,14,25541,1728257722,1727859381
1875,13,26,-13,1726254867,1728324120
1877,8,110,-102,1726376749,1727011132
1879,9,150,-141,1727940197,1726890623
1881,19392,1500,17892,1728214207,1728419748
1885,850,850,0,1728564542,1728564690
1887,50,20,30,1728565909,1728565885
1891,338,330,8,1728565761,1728565360
1897,380,348,32,1728565780,1728565813
1905,316,168,148,1728565954,1728564212
1907,126,121,5,1728565918,1728563574
1909,200,200,0,1728565910,1728550494
1911,1,150,-149,1728542676,1728532116
1913,650,500,150,1728565943,1728565104
1915,67272,385,66887,1726518298,1728535853
1917,109,107,2,1728565927,1728565417
1919,56,50,6,1728565955,1728565867
1921,57,54,3,1728565929,1728565281
1923,28,24,4,1728565503,1728565767
1925,8,7,1,1728565785,1728565878
1927,48,45,3,1728565960,1728563859
1929,37,33,4,1728566000,1728565900
1931,10,10,0,1728565746,1728565593
1933,157,156,1,1728565975,1728564551
1935,2,3,-1,1728565864,1728565796
1937,32,32,0,1728565998,1728564234
1939,5,4,1,1728565998,1728565974
1941,10,7,3,1728565937,1728564783
1942,73,72,1,1728565624,1728564927
1944,40,40,0,1728565914,1728565060
1947,63,55,8,1728565859,1728564858
1949,313,266,47,1728565742,1728564379
1951,98,95,3,1728565865,1728565528
1953,252,237,15,1728565074,1728563986
1955,66,65,1,1728564389,1728565817
1957,105,110,-5,1728564617,1728565732
1959,9062,10040,-978,1728565491,1728559617
1961,6000,5991,9,1728562796,1728564015
1963,84,70,14,1728565994,1728565310
1965,90,84,6,1728565959,1728565888
1969,169,416,-247,1728552863,1728565974
1971,40,39,1,1728565922,1728565216
1973,48,48,0,1728565847,1728565461
1975,83,82,1,1728565844,1728565982
1978,108,110,-2,1728565553,1728565612
1980,4,4,0,1728565811,1728565568
1982,26,25,1,1728565534,1728565822
1985,93,84,9,1728565894,1728565845
1987,16,15,1,1728565563,1728565949
1989,12996,10000,2996,1728565084,1728562837
1993,5,4,1,1728565936,1728565830
2003,63,62,1,1728565882,1728565875
2007,40,27,13,1728565713,1728565599
2011,568,544,24,1728565424,1728565223
2015,239,239,0,1728565832,1728554019
2017,250,250,0,1728534919,1728565559
2019,420,215,205,1728553722,1728563272
2021,300,300,0,1728553729,1728554009
2023,125,125,0,1728322366,1728540409
2025,24,23,1,1728565476,1728565907
2026,49,40,9,1728553969,1728558624
2028,759,250,509,1728565548,1728556238
2030,3,5,-2,1728528531,1728500435
2032,2900,99,2801,1726781562,1728359674
2034,1,9000,-8999,1728560483,1728404533
2036,27,27,0,1728378080,1728230471
2038,25,100,-75,1726238086,1728462605
2040,20,2,18,1728266475,1728248778
2048,10000,5000,5000,1728541818,1728563923
2054,3333,1002,2331,1728565474,1728547982
2064,4191,1000,3191,1728563830,1728548045
2074,9849,5000,4849,1728541897,1728547980
2080,2997,850,2147,1728541831,1728547978
2084,2525,1800,725,1728565852,1728557426
2092,17000,6000,11000,1728541876,1728547984
2102,350,250,100,1728565997,1728565827
2104,20,5,15,1728482144,1728447658
2106,99,66,33,1728552386,1728163969
2108,108,105,3,1728565701,1728565196
2110,95,99,-4,1728511936,1728408596
2112,500,500,0,1728564915,1728530799
2114,155,155,0,1728565799,1728565900
2116,174,183,-9,1728565841,1728534981
2118,150,96,54,1728553379,1728564560
2120,160,150,10,1728558544,1728565071
2122,1,1001,-1000,1728565544,1727911244
2124,70,50,20,1728507034,1728551888
2126,98,80,18,1728565282,1728565918
2128,100,100,0,1728565558,1728562460
2130,20,20,0,1728565973,1728557750
2132,91,91,0,1728565575,1728563523
2134,107,103,4,1728565993,1728557065
2136,98,60,38,1728565917,1728564817
2138,82,69,13,1728565935,1728565799
2140,170,85,85,1728562486,1728565811
2142,91,83,8,1728565768,1728564025
2150,288,278,10,1728565737,1728565707
2152,512,461,51,1728562868,1728564571
2162,412,400,12,1728565550,1728563933
2164,44,6,38,1728534729,1728564066
2165,2000,265,1735,1728500081,1728563888
2166,4000,564,3436,1728562982,1728563893
2167,1,1,0,1728538729,1728419386
2169,238,245,-7,1728565408,1728562452
2171,46,46,0,1728564927,1728561004
2185,500,500,0,1728565925,1728565035
2187,698,595,103,1728565438,1728564044
2191,3191,750,2441,1728541603,1728350958
2195,799,1560,-761,1728541590,1728444970
2205,5000,4005,995,1728563385,1728562398
2209,3000,788,2212,1728542057,1728562459
2213,4999,2501,2498,1728547490,1728548052
2217,6500,5238,1262,1728565687,1728558754
2219,30,400,-370,1727939048,1726430566
2221,43,54,-11,1723124774,1728400760
2223,8000,500,7500,1727939018,1727659901
2225,37,85,-48,1728123553,1726067317
2227,41,1,40,1728164250,1723160699
2229,372,372,0,1728495553,1728354969
2231,10000,351,9649,1726197309,1728384226
2233,13,63,-50,1728499441,1728339973
2235,18,100,-82,1727747854,1726323965
2237,19001,541,18460,1728065693,1728412519
2239,52,500,-448,1728452374,1728170037
2241,40000,81,39919,1728243518,1728502671
2243,640,1037,-397,1728563539,1728491266
2253,4642,1695,2947,1728548951,1728563992
2255,1204,1200,4,1728551409,1728563987
2259,750,11,739,1728521979,1728564033
2277,41998,3652,38346,1728548034,1728563948
2281,13989,4001,9988,1728559182,1728564002
2283,220,210,10,1728557490,1728561728
2289,634,630,4,1728565286,1728557124
2293,450,371,79,1728562817,1728565405
2297,800,779,21,1728564394,1728565430
2301,853,837,16,1728565974,1728565717
2307,497,442,55,1728565584,1728565927
2309,247,243,4,1728565990,1728565856
2313,38,36,2,1728565337,1728565948
2315,382,378,4,1728565731,1728565710
2317,564,480,84,1728528082,1728536869
2319,531,558,-27,1728505700,1728555105
2321,500,545,-45,1728564788,1728527585
2323,59,51,8,1728565991,1728565958
2325,466,320,146,1728565985,1728565079
2327,196,65,131,1728564660,1728565834
2337,3251,3690,-439,1728536103,1728563896
2341,5347,5315,32,1728560288,1728556030
2343,3700,3083,617,1728565648,1728565037
2347,54,50,4,1728565952,1728565975
2349,133,122,11,1728565997,1728565973
2351,201,196,5,1728565992,1728565912
2353,679,668,11,1728565987,1728565899
2355,116,112,4,1728565989,1728565611
2357,105,105,0,1728566001,1728565896
2359,677,677,0,1728565946,1728565911
2361,1809,1801,8,1728565995,1728565997
2363,12412,12408,4,1728565967,1728565969
2366,65353,64422,931,1728563039,1728565230
2368,775000,651000,124000,1728563046,1728533748
2370,304,367,-63,1728540925,1728441095
2428,20,11,9,1728565423,1728564536
2430,91,90,1,1728565911,1728564040
2432,700,729,-29,1728565896,1728565531
2434,9810,9707,103,1728565997,1728565990
2436,1610,1580,30,1728565810,1728565991
2438,82,28,54,1728564908,1728524559
2440,5399,5374,25,1728565995,1728565446
2442,5448,5375,73,1728565900,1728565999
2444,2596,2541,55,1728565993,1728565978
2446,229,222,7,1728565965,1728565978
2448,1289,1399,-110,1728565997,1728565626
2450,1799,1300,499,1728564615,1728565870
2452,1169,1158,11,1728565861,1728562117
2454,780,781,-1,1728552515,1728565868
2456,350,320,30,1728565361,1728555607
2458,212,202,10,1728562220,1728557137
2460,487,350,137,1728565467,1728565074
2462,300,150,150,1728563459,1728565073
2464,120,100,20,1728565931,1728565082
2466,1,1,0,1728565951,1728540312
2468,1000,987,13,1728565965,1728565078
2470,118,100,18,1728565939,1728565093
2472,199,150,49,1728564333,1728565080
2474,355205,251003,104202,1728560528,1728565062
2476,48465,38533,9932,1728564775,1728565314
2481,2049,1960,89,1728565595,1728565934
2483,2099,2096,3,1728565348,1728563086
2485,2100,1951,149,1728564237,1728566000
2487,1650,1452,198,1728565965,1728565681
2489,2480,1792,688,1728565915,1728565771
2491,2392,2333,59,1728565961,1728565790
2493,2207,2200,7,1728565966,1728565863
2495,3386,2803,583,1728565799,1728565647
2497,4349,4562,-213,1728565405,1728565811
2499,5280,5254,26,1728565990,1728565919
2501,6226,6213,13,1728565636,1728565735
2503,7700,7572,128,1728565972,1728565890
2505,2228,2228,0,1728565996,1728565996
2507,3335,3260,75,1728565569,1728565065
2509,5388,5324,64,1728565962,1728565483
2520,899,500,399,1728563653,1728561371
2522,317,500,-183,1728552516,1728564845
2524,228,200,28,1728524115,1728527307
2526,339,500,-161,1728520902,1728564015
2550,653,641,12,1728565867,1728565612
2552,691,675,16,1728565955,1728565209
2568,1098,1073,25,1728564004,1728564714
2570,1891,1831,60,1728565715,1728565977
2572,12158,12200,-42,1728565917,1728566000
2577,31576533,31401103,175430,1728565909,1728565964
2579,213849,205552,8297,1728565398,1728565275
2581,1390000,1279316,110684,1728565875,1728563952
2583,14265,15753,-1488,1728563534,1728532646
2585,16941,16055,886,1728537985,1728561051
2587,14171,16527,-2356,1728554062,1728563503
2589,10000,7777,2223,1728542053,1728560857
2591,144000,115000,29000,1728513395,1728564147
2593,68196,57500,10696,1728554077,1728558442
2595,110583,110583,0,1728525483,1728564140
2597,100448,107777,-7329,1728519318,1728564986
2599,11000,9682,1318,1728504522,1728565097
2601,3920,3400,520,1728560886,1728562674
2603,3176,3003,173,1728565613,1728563092
2605,4659,4739,-80,1728505313,1728564259
2607,17186,22971,-5785,1728541569,1728565128
2609,4093,4000,93,1728563022,1728564172
2611,6349,6000,349,1728560698,1728562947
2613,11887,10000,1887,1728565286,1728565293
2615,85000,81460,3540,1728565650,1728565577
2617,49000,48322,678,1728564938,1728565677
2619,116000,115000,1000,1728565756,1728565428
2621,121476,120000,1476,1728564101,1728563886
2623,40872,40872,0,1728565306,1728565943
2625,38266,37822,444,1728552460,1728563169
2627,27200,27000,200,1728558229,1728565951
2629,36209,32550,3659,1728565391,1728560413
2631,47351,36000,11351,1728511495,1728565150
2633,21344,16627,4717,1728515048,1728555812
2635,100000,70152,29848,1728563829,1728547606
2637,650000,150000,500000,1728510643,1728537219
2639,1826,2400,-574,1728533915,1728565061
2641,2500,2425,75,1728522815,1728559409
2643,60485,41953,18532,1728533558,1728563323
2645,4085,3500,585,1728562383,1728565024
2647,7000,6000,1000,1728559431,1728565164
2649,2252,1000,1252,1728556354,1728550821
2651,113405,139999,-26594,1728557924,1728560033
2653,44734,39324,5410,1728549462,1728565473
2655,37906,37620,286,1728560657,1728563370
2657,700896,685000,15896,1728564387,1728565112
2659,37367,34550,2817,1728562324,1728565476
2660,50000,,N/A,1618883126,
2661,70079,67666,2413,1728556293,1728565232
2663,69999,57000,12999,1728536162,1728562177
2665,90000,87666,2334,1728563940,1728563333
2667,77212,78555,-1343,1728531173,1728561006
2669,52735,41325,11410,1728559288,1728561803
2671,55000,41897,13103,1728559304,1728564755
2673,26615,24000,2615,1728562833,1728563325
2675,34783,34783,0,1728558182,1728560830
2859,543,541,2,1728565510,1728564587
2861,58,100,-42,1728563540,1728563859
2862,400,232,168,1728565518,1728561527
2864,87,74,13,1728549801,1728564064
2865,118,118,0,1728557490,1728565623
2866,178,173,5,1728565933,1728565183
2876,1700,1650,50,1728565965,1728565804
2878,355,355,0,1728560836,1728565813
2890,850,1,849,1728565276,1728560052
2894,919,350,569,1728561630,1728556655
2896,474,1039,-565,1728526873,1728458036
2898,9995,1603,8392,1728445270,1728535739
2900,1800,1119,681,1728527787,1728565082
2902,600,555,45,1728564377,1728556595
2904,1178,1131,47,1728565459,1728564864
2906,705,1151,-446,1728564755,1728552131
2908,875,1019,-144,1728565446,1728498195
2910,865,1508,-643,1728562440,1728551946
2912,964,121,843,1728562674,1728565797
2914,1395,1339,56,1728565975,1728563529
2916,1650,3,1647,1728525051,1728456748
2918,2264,5000,-2736,1728513715,1728519585
2920,1121,1559,-438,1728439590,1728565089
2922,1093,1074,19,1728564246,1728563331
2924,10000,1401,8599,1728538382,1728558244
2926,700,543,157,1728534690,1728104539
2928,37553,1437,36116,1728240490,1728557334
2930,1225,1225,0,1728565076,1728558241
2932,513,251,262,1728542874,1728557354
2934,1039,1037,2,1728565681,1728563282
2936,4994,690,4304,1728479316,1728540409
2938,7000,2000,5000,1728496596,1728528140
2940,1989,1900,89,1728544361,1728565094
2942,956,900,56,1728565456,1728565794
2955,138,138,0,1728528645,1728532106
2961,131,123,8,1728565858,1728550293
2970,278,274,4,1728565982,1728565916
2972,1500,1500,0,1728557980,1728520113
2974,3925,2850,1075,1728564166,1728519021
2976,407,22,385,1728556213,1728555388
2997,3384000,3252525,131475,1728557439,1728565580
2998,3499,3450,49,1728565705,1728565997
3000,8174,8176,-2,1728564967,1728565971
3002,3608,3552,56,1728565905,1728565629
3004,8457,8311,146,1728565876,1728565960
3008,520,496,24,1728565996,1728565010
3010,314,311,3,1728564704,1728565961
3012,295,250,45,1728544309,1728561889
3014,111,129,-18,1728535755,1728561385
3016,5030,4978,52,1728565998,1728565874
3018,3600,3525,75,1728565352,1728565897
3020,2286,2170,116,1728558227,1728563522
3022,1238,1183,55,1728541420,1728564513
3024,11044,10978,66,1728565970,1728565998
3026,8080,8040,40,1728565286,1728565953
3028,5321,5322,-1,1728559611,1728564995
3030,2670,2670,0,1728559614,1728565840
3032,306,303,3,1728565856,1728564647
3034,126,126,0,1728556548,1728565957
3036,177,170,7,1728549030,1728556639
3038,117,96,21,1728560336,1728563481
3040,125,111,14,1728565955,1728565295
3042,89,91,-2,1728564021,1728565150
3044,54,53,1,1728546792,1728565742
3046,50,30,20,1728565255,1728564820
3049,3436,3375,61,1728565833,1728565994
3051,8150,8118,32,1728565947,1728565988
3053,9443,9401,42,1728565885,1728566001
3054,28000,26203,1797,1728562286,1728565711
3093,5723,1555,4168,1728554482,1728520511
3094,8000,206,7794,1726962815,1727423118
3095,45,1,44,1728508167,1728241610
3096,16444,135,16309,1728545213,1728565997
3097,307,300,7,1728561382,1728565598
3098,46802,7165,39637,1728544272,1728541244
3099,668,774,-106,1728361373,1728550580
3100,1609,1581,28,1728140997,1728560858
3101,30000,10550,19450,1728528336,1728563233
3105,409,461,-52,1728563831,1728565618
3107,2328,1400,928,1728565042,1728562884
3122,36985,34302,2683,1728565185,1728565693
3123,7000,823,6177,1728500209,1728500469
3125,999,992,7,1728565926,1728565955
3138,50,45,5,1728565945,1728565913
3140,173206,171000,2206,1728565055,1728565943
3142,395,395,0,1728565989,1728565636
3144,508,497,11,1728565973,1728565978
3157,2999,1958,1041,1728564982,1728521714
3159,2678,1194,1484,1728564572,1728548263
3162,350,44,306,1728565840,1728561232
3183,495,476,19,1728565716,1728565959
3188,207,65,142,1728564576,1728565464
3190,5000,626,4374,1728524950,1728223425
3192,842,842,0,1728517978,1728493195
3194,1500,3120,-1620,1728328792,1727637429
3196,5000,2500,2500,1728522999,1728535461
3198,6600,6797,-197,1728545194,1728396083
3200,10698,10698,0,1728565733,1728562486
3202,37851,36216,1635,1728565488,1728565924
3204,149742,149193,549,1728564462,1728565865
3211,132,126,6,1728565477,1728565982
3216,927,824,103,1728565832,1728565945
3226,250,105,145,1728524414,1728481106
3228,256,69,187,1728565470,1728513985
3239,57,57,0,1728565987,1728565662
3325,1070,1031,39,1728565904,1728565992
3327,178,20,158,1728556303,1728533872
3329,117,150,-33,1728556199,1728331341
3331,30,7,23,1728556316,1728551925
3333,5000,4000,1000,1728420656,1728558779
3335,1,90,-89,1728556212,1728146175
3337,75,25,50,1728556227,1728518033
3339,897,843,54,1728525171,1728562085
3341,1530,598,932,1728464010,1728501916
3343,3577,1000,2577,1728565385,1728526887
3345,9999,210,9789,1728548905,1728548266
3347,287,251,36,1728563154,1728234644
3349,144,5,139,1728565953,1728533878
3351,39998,1450,38548,1728556928,1728536612
3353,3687,3300,387,1728560419,1728555730
3355,266,1104,-838,1728556342,1728336448
3357,597,400,197,1728547579,1728533805
3359,262,275,-13,1728556772,1728530743
3361,2976,2976,0,1728560611,1728541045
3363,490,420,70,1728565937,1728562149
3365,2172,720,1452,1728544489,1728488384
3367,2050,1884,166,1728564859,1728535013
3369,600,530,70,1728565257,1728562967
3371,2472,3441,-969,1728560854,1728442190
3373,2225,1940,285,1728563937,1728518911
3379,385,289,96,1728565983,1728547514
3381,2000,74,1926,1728533196,1728534187
3385,6986,5900,1086,1728564756,1728559628
3387,31325,30648,677,1728565330,1728565505
3389,24571,24014,557,1728565993,1728564152
3391,2474,2650,-176,1728512531,1728564733
3393,8300,7000,1300,1728562533,1728563707
3396,99,61,38,1728558706,1728565880
3398,3369,3086,283,1728556009,1728564594
3400,4400,3935,465,1728551308,1728563277
3402,4299,4299,0,1728565558,1728556797
3404,6000,5402,598,1728565790,1728560585
3406,3900,365,3535,1728563035,1728563671
3408,25,20,5,1728562187,1728564620
3410,1,10,-9,1728525971,1728564614
3412,3,3,0,1728552841,1728544944
3414,18,2,16,1728565604,1728549628
3420,198,198,0,1728565887,1728564642
3422,35,34,1,1728564475,1728564911
3424,48,11000,-10952,1728275910,1728539356
3426,33,33,0,1728543348,1728545052
3428,20,22,-2,1728554277,1728258994
3430,3627,3500,127,1728565893,1728564240
3432,2464,2500,-36,1728564081,1728533154
3434,1291,1150,141,1728560477,1728564905
3436,1999,550,1449,1728554337,1728562102
3438,1688,1552,136,1728564177,1728561689
3440,1703,2537,-834,1728564897,1728525493
3442,8000,2021,5979,1728565226,1728551219
3444,2513,1947,566,1728564647,1728565002
3446,4095,4095,0,1728551410,1728565631
3448,6450,6548,-98,1728565808,1728564538
3470,7600,7351,249,1728538089,1728565414
3472,3632,3525,107,1728504985,1728561044
3473,8303,4555,3748,1728533423,1728547224
3474,3949,3582,367,1728548372,1728565071
3475,3342,2874,468,1728547562,1728565018
3476,49650,45384,4266,1728564892,1728561431
3477,37995,48490,-10495,1728548757,1728565934
3478,50000,37899,12101,1728536732,1728555011
3479,38647,38283,364,1728564782,1728560036
3480,59000,38020,20980,1728551633,1728565312
3481,7432204,7230000,202204,1728565924,1728564463
3483,6849840,6753000,96840,1728565079,1728564484
3485,1540000,1488955,51045,1728563110,1728554415
3486,8999000,8602000,397000,1728556639,1728563447
3488,6399986,6075000,324986,1728556681,1728564474
3678,6498,5513,985,1728565961,1728564925
3749,41610,40406,1204,1728565878,1728565980
3751,81219,79000,2219,1728565882,1728565905
3753,99999,46200,53799,1728562841,1728565895
3755,41352,36770,4582,1728565115,1728565733
3759,3998,1122,2876,1728562795,1728440138
3761,250,65,185,1728520320,1728558347
3763,747,2395,-1648,1728543649,1728447214
3765,9999,1543,8456,1728563717,1728542021
3767,1,72,-71,1728559976,1728156152
3769,458,100000,-99542,1728519568,1726613263
3771,2459,878,1581,1728501045,1728526529
3773,75000,672,74328,1728485410,1728435080
3775,762,884,-122,1728544704,1728362162
3777,1424,1424,0,1728555910,1728542848
3779,579,4224,-3645,1728369982,1728532736
3781,770,1006,-236,1728536510,1728441898
3783,559,100,459,1728534589,1728440153
3785,76,65,11,1728562417,1728557926
3787,2475,2412,63,1728523446,1728537608
3789,2333,105,2228,1728562026,1728563280
3791,500,275,225,1728555525,1728552195
3793,532,20000,-19468,1728531813,1728131560
3795,525,5000,-4475,1728531827,1728076201
3797,1488,999,489,1728531797,1728557836
3799,225,1000,-775,1728563830,1728564990
3801,744,700,44,1728563177,1728563767
3803,206,102,104,1728489567,1728553751
3827,1405,1065,340,1728564745,1728565457
3828,3600,2974,626,1728564785,1728565496
3829,50000,1051,48949,1728563349,1728565107
3830,1104,1051,53,1728564815,1728565173
3831,8182,9015,-833,1728564913,1728565562
3832,12998,7501,5497,1728564585,1728565339
3833,11000,6001,4999,1728564600,1728564573
3834,10000,7906,2094,1728565365,1728563354
3835,2080,2021,59,1728563701,1728565637
3836,22999,1999,21000,1728562512,1728565213
3837,1865,3642,-1777,1728562525,1728565569
3838,1788,1749,39,1728564867,1728564990
3853,810,755,55,1728565966,1728565454
4012,207,205,2,1728565857,1728563284
4014,399,53,346,1728565823,1728559165
4016,3999,500,3499,1728479346,1728374577
4087,161408,161401,7,1728565854,1728565999
4089,19867,16159,3708,1728565914,1728565815
4091,71582,71250,332,1728565919,1728565992
4093,47561,47550,11,1728565910,1728566001
4095,6690,6381,309,1728565907,1728565555
4097,6640,7124,-484,1728565725,1728565552
4099,89000,82675,6325,1728558360,1728565822
4101,72411,71301,1110,1728565623,1728565554
4103,50000,47321,2679,1728565902,1728565841
4105,6251,6055,196,1728556441,1728564175
4107,97531,97531,0,1728562762,1728565826
4109,9144,8617,527,1728561657,1728565866
4111,72500,71899,601,1728561639,1728565926
4113,49995,47199,2796,1728563663,1728565065
4115,5555,5250,305,1728565191,1728565414
4117,12260,11319,941,1728563441,1728563186
4119,4500,780,3720,1728555087,1728561453
4121,6407,5000,1407,1728565225,1728564870
4123,270000,151,269849,1728378936,1728564136
4125,307,312,-5,1728558252,1728564833
4127,616,560,56,1728565400,1728565309
4129,3000,3000,0,1728565505,1728565623
4131,7499,7100,399,1728565994,1728565783
4151,1357465,1336376,21089,1728565976,1728566000
4153,696204,690000,6204,1728565955,1728565992
4156,8250,4815,3435,1728565499,1728563543
4161,23,16,7,1728565707,1728562762
4162,1999,601,1398,1728564930,1728563029
4164,465,300,165,1728565628,1728562783
4166,331,1636,-1305,1728565820,1728514297
4168,490,1016,-526,1728565885,1728564650
4170,22284,21194,1090,1728564493,1728565869
4207,346248,341004,5244,1728565700,1728565949
4298,227,60,167,1728564863,1728565127
4300,2000,2000,0,1728564854,1728565611
4302,446,423,23,1728564875,1728565144
4304,2071,3117,-1046,1728564874,1728562844
4306,2439,2400,39,1728564894,1728565117
4308,1833,1750,83,1728564937,1728565141
4310,562,555,7,1728565930,1728555001
4315,1170,1170,0,1728562871,1728553523
4317,1026,324,702,1728553634,1728562757
4319,216,680,-464,1728560617,1728534216
4321,452,505,-53,1728397691,1728534750
4323,450,6369,-5919,1728327716,1728545586
4325,96,69,27,1728531973,1728538400
4327,246,25,221,1728565671,1728433057
4329,1100,25,1075,1728531929,1728401959
4331,63,10,53,1728542593,1728481811
4333,2500,350,2150,1728557321,1728546058
4335,4405,943,3462,1728555860,1728559724
4337,402,100,302,1728560287,1728562770
4339,4444,315,4129,1728561781,1728534709
4341,802,25,777,1728565813,1728514582
4343,600,300,300,1728564594,1728545333
4345,200,107,93,1728561764,1728565015
4347,4000,2000,2000,1728562518,1728534052
4349,100,100,0,1728565467,1728531833
4351,374,150,224,1728561252,1728538324
4353,800,415,385,1728553027,1728552886
4355,589,1051,-462,1728524678,1728545417
4357,2200,1000,1200,1728537500,1728562730
4359,590,301,289,1728530519,1728558953
4361,7172,5000,2172,1728517761,1728560311
4363,687,25,662,1728549201,1728330787
4365,176,150,26,1728564286,1728539550
4367,1883,1500,383,1728530778,1728560779
4369,447,25,422,1728554529,1728501210
4371,460,124,336,1728543959,1728565887
4373,288,281,7,1728545530,1728565696
4375,4000,3070,930,1728427460,1728527533
4377,1999,641,1358,1728523905,1728562739
4379,400,251,149,1728526735,1728547903
4381,571,25,546,1728478734,1728502281
4383,299,138,161,1728561723,1728539107
4385,25,25,0,1728397109,1728552329
4387,83,80,3,1728520565,1728531444
4389,318,50,268,1728549012,1728462950
4391,7500,1500,6000,1728515036,1728539138
4393,314,372,-58,1728561955,1728548517
4395,1400,1345,55,1728560969,1728515793
4397,589,2,587,1728562829,1728562788
4399,10000,287,9713,1728377687,1728553839
4401,4999,898,4101,1728511155,1728531347
4403,1000,145,855,1728559848,1728516584
4405,95,100,-5,1728561476,1728559632
4407,310,25,285,1728562107,1728549290
4409,575,350,225,1728565163,1728530636
4411,315,315,0,1728558075,1728540937
4413,275,304,-29,1728554122,1728499555
4417,2993,2929,64,1728565495,1728565526
4419,1989,1850,139,1728558938,1728563484
4421,1200,1200,0,1728417208,1728565598
4423,567,539,28,1728555322,1728561015
4436,831,960,-129,1728558762,1728557532
4438,2,5000,-4998,1728448540,1727282070
4440,172,171,1,1728564635,1728561553
4456,943,220,723,1728565824,1728558795
4458,3000,27,2973,1728506412,1728514015
4460,350,368,-18,1728564900,1728559582
4517,9999,6231,3768,1728562721,1728563540
4522,1230,1430,-200,1728564178,1728534277
4525,52,50,2,1728543647,1728563159
4527,6,6,0,1728565362,1728565920
4529,520,520,0,1728565412,1728402211
4532,15000,12679,2321,1728562480,1728507816
4535,3000,5,2995,1728556685,1727824452
4537,512,2,510,1728565378,1728556769
4540,1,1,0,1728556831,1728268220
4542,20,18,2,1728565838,1728565597
4544,263,409,-146,1728562607,1728527347
4546,957,1003,-46,1728563193,1728491213
4548,1990,1823,167,1728565906,1728564920
4551,939,49,890,1728564950,1728563883
4580,1971,2001,-30,1728422888,1728565454
4582,6973,1000000,-993027,1727485189,1723167579
4585,161469,161000,469,1728565273,1728565985
4587,60200,59200,1000,1728565891,1728565925
4591,261,274,-13,1728552340,1727821619
4593,1,244,-243,1728558571,1728414177
4600,5000,195,4805,1728541551,1728564879
4608,418,402,16,1728551770,1728501494
4627,1372,901,471,1728565602,1728565761
4668,208,100,108,1728565696,1728505459
4675,72007,74095,-2088,1728565238,1728565997
4684,9900,4288,5612,1728565621,1728565505
4687,468,473,-5,1728565849,1728555162
4689,50000,1000,49000,1727409828,1728528445
4694,118,116,2,1728564800,1728565734
4695,116,115,1,1728565938,1728565902
4696,10,10,0,1728565826,1728565998
4697,54,51,3,1728565869,1728565990
4698,127,124,3,1728565868,1728565972
4699,24,21,3,1728565963,1728565964
4708,308418,302723,5695,1728565841,1728565746
4710,235007,230000,5007,1728565924,1728565949
4712,3989218,3945400,43818,1728565849,1728565741
4714,2900000,2855000,45000,1728565849,1728565739
4716,410950,402968,7982,1728565026,1728565741
4718,2289998,2253360,36638,1728565415,1728565972
4720,817000,795000,22000,1728562469,1728565960
4722,1036265,1033692,2573,1728565343,1728563698
4724,228173,230000,-1827,1728562811,1728565137
4726,219000,206000,13000,1728564393,1728564689
4728,422969,360000,62969,1728565403,1728565149
4730,293764,295000,-1236,1728562573,1728565170
4732,56993,56500,493,1728565750,1728565998
4734,109180,105237,3943,1728565389,1728564642
4736,1531816,1520000,11816,1728565803,1728565994
4738,881119,859007,22112,1728565807,1728565997
4740,97,76,21,1728565397,1728565967
4745,137995,131527,6468,1728565333,1728564517
4747,106500,104646,1854,1728565441,1728563748
4749,234000,230036,3964,1728565983,1728565555
4751,266000,262347,3653,1728565995,1728565314
4753,109502,107656,1846,1728565300,1728564585
4755,96231,94700,1531,1728561296,1728563680
4757,190000,162674,27326,1728565913,1728564574
4759,260000,250138,9862,1728565997,1728564591
4773,345,144,201,1728541777,1728550184
4778,70,40,30,1728545457,1728542792
4783,93,97,-4,1728564703,1728542874
4788,720,1888,-1168,1728537836,1728369231
4793,162,151,11,1728565549,1728557783
4798,264,237,27,1728564561,1728565360
4803,960,929,31,1728564765,1728565085
4812,482,358,124,1728557406,1728564599
4819,5,5,0,1728565832,1728565325
4820,12,12,0,1728564942,1728565930
4821,3500,1900,1600,1728541935,1728565711
4822,55,48,7,1728565862,1728565757
4823,135,128,7,1728564664,1728560735
4824,790,790,0,1728565626,1728563558
4825,700,10,690,1728554616,1728505427
4827,265,200,65,1728564923,1728564287
4830,3306,2000,1306,1728565611,1728565619
4832,8380,4773,3607,1728537504,1728529017
4834,40000,38001,1999,1728544617,1728564216
4842,800,739,61,1728565922,1728563564
4844,846,663,183,1728550218,1728563562
4846,389,383,6,1728535555,1728563579
4848,275,169,106,1728564256,1728555096
4850,2749,2749,0,1728565932,1728565933
4860,245700,244501,1199,1728564839,1728563075
4866,209983,173005,36978,1728552756,1728565077
4872,4074618,3903000,171618,1728508136,1728564650
4878,2885000,2890000,-5000,1728508128,1728565089
4884,399248,386902,12346,1728546193,1728565600
4890,2178291,2200011,-21720,1728526894,1728565610
4896,749449,735012,14437,1728546392,1728565897
4902,997000,973000,24000,1728562189,1728565893
4908,157677,174000,-16323,1728368622,1728562368
4914,160063,160000,63,1728552731,1728559679
4920,297357,297357,0,1728564019,1728565351
4926,232511,209000,23511,1728558783,1728564120
4932,18033,20004,-1971,1728563657,1728565704
4938,112499,95504,16995,1728562530,1728565711
4944,1430000,1429655,345,1728562401,1728565972
4950,821108,793000,28108,1728557204,1728565976
4956,97556,89111,8445,1728492564,1728556762
4962,97000,95101,1899,1728109128,1728565712
4968,169540,180000,-10460,1728556270,1728565780
4974,202084,197500,4584,1728537356,1728565782
4980,67158,70888,-3730,1728565651,1728565744
4986,95442,95350,92,1728382449,1728550122
4992,169700,167300,2400,1728382437,1728564138
4998,191633,187230,4403,1728563537,1728563579
5001,448,246,202,1728564716,1728562984
5003,5500,200,5300,1728367071,1728493020
5014,4500,1125,3375,1728564263,1728565428
5016,1038,1016,22,1728565464,1728563066
5018,2178,1003,1175,1728461378,1728547586
5024,1,8477,-8476,1728513093,1727885985
5026,840,1274,-434,1728471952,1728513200
5028,1317,500,817,1728520673,1728530109
5030,409,823,-414,1728544894,1728274450
5032,10000,10000,0,1728543004,1728499606
5034,15000,15000,0,1728558133,1728558133
5036,420,2,418,1728254467,1727112841
5038,729,50000,-49271,1728222565,1728438246
5040,10000,2000,8000,1728365408,1728461719
5042,1296,2,1294,1728536347,1728510418
5044,4996,100,4896,1728565330,1728529880
5046,3747,3666,81,1728564798,1728558813
5048,634,659,-25,1728510998,1728163684
5050,14000,2000,12000,1728558056,1728545967
5052,709,5000,-4291,1728140928,1728552659
5075,7265,7265,0,1728565446,1728565992
5096,7,6,1,1728565875,1728565831
5097,8,2,6,1728563289,1728565811
5098,15,2,13,1728561103,1728565809
5099,8,4,4,1728560675,1728565457
5100,22,20,2,1728565985,1728565457
5101,13,3,10,1728564984,1728565579
5102,10,6,4,1728562675,1728565807
5103,80,50,30,1728557805,1728565776
5104,36,6,30,1728560309,1728565468
5105,45,10,35,1728564481,1728565600
5106,80,50,30,1728565634,1728564730
5280,110,87,23,1728565799,1728565875
5281,390,342,48,1728565945,1728565711
5282,77,72,5,1728565748,1728563582
5283,47,21,26,1728564381,1728565982
5284,10,22,-12,1728556844,1728565855
5285,10,10,0,1728565983,1728565797
5286,100,55,45,1728564069,1728565980
5287,152,74,78,1728565633,1728565832
5288,658,688,-30,1728565930,1728566000
5289,33638,33641,-3,1728565761,1728565990
5290,69,69,0,1728565842,1728565382
5291,22,21,1,1728565795,1728565879
5292,20,15,5,1728565533,1728565131
5293,28,15,13,1728565561,1728565846
5294,44,36,8,1728565859,1728565863
5295,31600,31198,402,1728565988,1728565983
5296,1185,1159,26,1728565995,1728565984
5297,87,75,12,1728565464,1728565914
5298,3700,3500,200,1728565983,1728565966
5299,3474,3301,173,1728565989,1728565996
5300,47315,46972,343,1728565974,1728565993
5301,6967,6913,54,1728565974,1728565970
5302,531,432,99,1728565573,1728565868
5303,870,650,220,1728565757,1728565934
5304,7248,7248,0,1728565973,1728565991
5305,6,4,2,1728565991,1728565801
5306,3,3,0,1728565857,1728561075
5307,5,4,1,1728565699,1728565827
5308,5,4,1,1728565549,1728565792
5309,15,7,8,1728563467,1728565821
5310,8,5,3,1728563666,1728565818
5311,77,70,7,1728563257,1728565833
5312,116,127,-11,1728565776,1728565890
5313,63,85,-22,1728564252,1728565967
5314,5124,5100,24,1728565874,1728565967
5315,25250,25255,-5,1728565658,1728565998
5316,85000,84838,162,1728565360,1728566001
5318,1,1,0,1728565804,1728556246
5319,2,2,0,1728565924,1728559909
5320,4,3,1,1728564210,1728565963
5321,66,33,33,1728565996,1728565981
5322,10,3,7,1728560631,1728565816
5323,18,6,12,1728565799,1728565836
5324,2,2,0,1728565901,1728530618
5325,165,117,48,1728565843,1728565190
5329,63,62,1,1728565954,1728531018
5331,199,160,39,1728565831,1728565210
5341,125,124,1,1728565925,1728562057
5343,144,129,15,1728565851,1728561618
5345,49999,4187,45812,1728530040,1728561578
5350,6,6,0,1728565404,1728565580
5352,135,5000,-4865,1728523079,1728439991
5354,4,4,0,1728565956,1728565929
5370,400,360,40,1728565617,1728565864
5371,426,401,25,1728565845,1728565832
5372,6021,5344,677,1728565984,1728565568
5373,28600,28617,-17,1728565982,1728565867
5374,87932,86550,1382,1728565580,1728564700
5376,2,2,0,1728565217,1728565841
5386,780,550,230,1728565762,1728565846
5396,631,623,8,1728565865,1728565516
5406,813,801,12,1728565358,1728565976
5416,580,572,8,1728565971,1728564679
5418,2,2,0,1728565828,1728565722
5438,2900,1834,1066,1728565306,1728564079
5458,2248,1497,751,1728565293,1728563650
5478,1225,1289,-64,1728565309,1728555521
5496,301,301,0,1728565924,1728565372
5497,500,330,170,1728565558,1728565851
5498,499,147,352,1728565481,1728565569
5499,376,363,13,1728565519,1728563474
5500,318,256,62,1728565802,1728565518
5501,1792,1695,97,1728565959,1728565650
5502,38825,38043,782,1728565996,1728565618
5503,445,452,-7,1728565918,1728564584
5504,178,150,28,1728564361,1728565998
5516,2676,2000,676,1728565637,1728562332
5521,771,726,45,1728565951,1728565789
5523,800,524,276,1728565125,1728565459
5525,118,103,15,1728565724,1728565405
5527,17,6,11,1728565718,1728563856
5529,30,20,10,1728565788,1728565588
5531,100,60,40,1728565903,1728564376
5533,1,15,-14,1728565064,1728565874
5535,15,10,5,1728565857,1728563860
5537,43,30,13,1728565777,1728565185
5539,125,75,50,1728565893,1728559083
5541,500,500,0,1728564579,1728565582
5543,1,50,-49,1728563694,1728498194
5547,24000,25000,-1000,1728563776,1728565651
5549,450000,400000,50000,1728559364,1728526099
5574,3200,3399,-199,1728563899,1728565764
5575,5846,5621,225,1728565421,1728565759
5576,7500,7164,336,1728565432,1728565770
5616,19,24,-5,1728096113,1728495917
5617,27,97,-70,1725237268,1725777395
5618,148,148,0,1728402523,1728389318
5619,203,51,152,1728554741,1728540182
5620,252,207,45,1728541696,1728545749
5621,324,434,-110,1728536495,1728489817
5622,1280,58,1222,1728491837,1728330916
5623,300,200,100,1728484301,1728281803
5624,585,1021,-436,1728333923,1728528536
5625,1500,526,974,1728531145,1728540845
5626,35,31,4,1728542257,1728563527
5627,1341,932,409,1728565256,1728538807
5628,950,38,912,1728337717,1727410725
5629,19,37,-18,1725730992,1724299314
5630,4999,74,4925,1727484969,1714000135
5631,4999,40,4959,1727061741,1728284609
5632,750,223,527,1727440972,1728528879
5633,291,291,0,1728530511,1728550133
5634,665,94,571,1728529072,1728400481
5635,7000,60,6940,1727394760,1727909779
5636,24098,191,23907,1725932417,1728331042
5637,97,285,-188,1727942850,1727315188
5638,199000,500,198500,1725240807,1728027892
5639,250,857,-607,1727412826,1728562174
5640,307,240,67,1728181372,1728505506
5641,1158,1150,8,1728550623,1728565307
5642,5000,5000,0,1726252390,1726252390
5643,35000,50000,-15000,1728504042,1728489848
5644,10,2,8,1727649366,1727445605
5645,4,10,-6,1727150809,1710160445
5646,99888,99888,0,1728129499,1728129498
5647,627,1072,-445,1728555387,1728004809
5648,542,20,522,1727468505,1722914078
5649,41800,21,41779,1718145703,1727860744
5650,1,36,-35,1720896256,1707568049
5651,500,1000,-500,1727114956,1725200604
5652,395,395,0,1725960467,1725936984
5653,940,1330,-390,1728313893,1727917002
5654,46,50,-4,1728269317,1725903224
5655,3,3,0,1727808768,1727985722
5656,20000,20000,0,1728389357,1728389357
5657,414,501,-87,1728532037,1727804775
5658,143,1,142,1727138106,1726182878
5659,279,3,276,1728553325,1727967998
5660,440,124,316,1728561733,1728535682
5661,181,683,-502,1726702042,1723170385
5662,1455,1005,450,1728480455,1728548071
5663,468,468,0,1727558597,1727558596
5664,1207,575,632,1728509474,1727904596
5665,887,1161,-274,1728300267,1728337832
5666,1527,2,1525,1728526011,1728329571
5667,208,205,3,1728565777,1728565873
5668,1,49,-48,1728500533,1725796380
5670,4,200,-196,1728534299,1727858866
5672,888,500,388,1728328140,1728240347
5674,1,3540,-3539,1728129884,1722214647
5676,1855,1855,0,1728484302,1728005027
5678,4310,4310,0,1728559310,1728565042
5680,17131,17131,0,1728563399,1728564630
5682,1884,10,1874,1728388291,1727502393
5686,49000,4556,44444,1728488055,1728541666
5688,3868,100000,-96132,1728564362,1728192993
5690,73,2000,-1927,1728405160,1727875175
5692,2934,50,2884,1728518014,1728130281
5694,3376,4994,-1618,1728507811,1728427879
5696,7708,11498,-3790,1728560749,1728517434
5698,23318,22953,365,1728565863,1728565849
5700,24999,3567,21432,1728364258,1728561348
5704,1000,500000,-499000,1727524373,1727461923
5706,386438,176,386262,1727130724,1728279853
5708,227,99999,-99772,1728165568,1728321790
5710,800,300,500,1727342978,1702988838
5712,2089,2044,45,1728184139,1726679957
5714,13333,10014,3319,1728519756,1728430810
5716,100000,39662,60338,1728541410,1728433839
5718,100,98,2,1727617825,1727062111
5720,100000,4,99996,1728079856,1728346625
5722,492,1000,-508,1727925906,1726089363
5724,1,4457,-4456,1728469247,1713213677
5726,6624,6624,0,1728170106,1728518496
5728,22290,21734,556,1728543812,1728562161
5730,49249,47224,2025,1728561784,1728563283
5734,7327,11040,-3713,1728008124,1718954667
5736,1,5050,-5049,1728002804,1724987261
5739,15312,30000,-14688,1728457782,1727458990
5741,19086,24171,-5085,1727738083,1727726172
5743,26604,26500,104,1728564068,1728565971
5745,664000,607,663393,1727719032,1728404633
5747,15609,8000,7609,1728565900,1728565527
5749,4839,4929,-90,1728514297,1725376068
5751,825,1850,-1025,1728557524,1728354891
5753,55000,52000,3000,1728564875,1728565188
5755,415,468,-53,1728565428,1728557742
5757,37709,28787,8922,1728565905,1728541175
5759,64,60,4,1728532959,1728565905
5761,68827,72449,-3622,1728524834,1728520076
5763,253,100,153,1728540528,1728522485
5765,176888,109004,67884,1728550412,1728423436
5767,1798,1185,613,1728563184,1728532116
5769,145,176,-31,1728554677,1728500504
5777,40000,30000,10000,1728550759,1728532816
5785,37649,43582,-5933,1728534529,1728507603
5793,17000,23,16977,1728549211,1728525214
5801,22943,104820,-81877,1728402794,1728526415
5809,8846,10280,-1434,1728020689,1726881813
5817,43827,77301,-33474,1728379719,1728558852
5825,25000,18426,6574,1728399217,1728530471
5833,10022,1100,8922,1728545257,1728230203
5841,20000,16308,3692,1728505713,1728483143
5849,20000,19434,566,1728420162,1728453121
5857,271000,280973,-9973,1728501668,1728357954
5865,100000,100000,0,1728295639,1728295639
5873,157424,150000,7424,1728511458,1728531293
5881,30000,28794,1206,1728144024,1727150178
5889,150000,21656,128344,1728379771,1720312217
5897,200000,266417,-66417,1728379731,1728552668
5905,208000,79756,128244,1728520643,1728420224
5913,222607,144486,78121,1728492127,1728315571
5921,242000,242000,0,1728509868,1728388460
5929,425000,425000,0,1727762709,1727299784
5931,1346,1285,61,1728564283,1728565983
5933,1725,1600,125,1728565161,1728565089
5935,132,132,0,1728563954,1728565697
5937,1000,800,200,1728532014,1728563495
5940,4938,4925,13,1728565142,1728565832
5943,1989,1407,582,1728564566,1728564273
5945,1938,515,1423,1728546428,1728557145
5947,1150,600,550,1728565300,1728534493
5949,738,738,0,1728563032,1728563033
5952,6846,6765,81,1728565798,1728565994
5954,4391,4460,-69,1728525771,1728565720
5956,3000,3000,0,1728551954,1728565923
5958,2100,1933,167,1728563593,1728565782
5968,504,525,-21,1728564910,1728565836
5970,15,15,0,1728565344,1728565916
5972,2771,2696,75,1728565991,1728565997
5974,4000,3960,40,1728565983,1728565992
5980,122,118,4,1728555546,1728565810
5982,35,31,4,1728565757,1728565900
5984,78,78,0,1728538884,1728562096
5986,48,55,-7,1728565324,1728557855
5988,222,182,40,1728523881,1728558190
5992,2000,2000,0,1728449619,1728449904
5994,864,5000,-4136,1728519312,1728530783
5996,175,100,75,1728534187,1728545574
5998,1201,1187,14,1728565923,1728565875
6000,84,84,0,1728530761,1728530766
6002,99,31,68,1728512472,1728563997
6004,178,283,-105,1728564117,1728565661
6006,667,624,43,1728545646,1728562511
6008,1103,850,253,1728565906,1728557321
6010,500,400,100,1728536133,1728565284
6012,228,227,1,1728538175,1728565841
6014,159,152,7,1728475824,1728564468
6016,1956,1920,36,1728566001,1728565976
6018,83,80,3,1728565815,1728565809
6020,115,162,-47,1728368084,1728564677
6022,75,245,-170,1728533366,1728561930
6024,160,130,30,1728552465,1728562716
6026,626,553,73,1728541614,1728561931
6028,334,337,-3,1728502734,1728564732
6030,845,720,125,1728552515,1728562960
6032,20,10,10,1728566001,1728565274
6034,50,31,19,1728565936,1728565682
6036,148,100,48,1728565859,1728542738
6038,1344,2239,-895,1728526621,1728445611
6043,101,101,0,1728550719,1728565871
6045,7,7,0,1728550727,1728565583
6047,70,70,0,1728564933,1728565236
6049,131,125,6,1728565584,1728564420
6051,6520,6678,-158,1728561799,1728565641
6055,187,237,-50,1728565604,1728565996
6061,15000,287,14713,1726777249,1727793929
6062,783,10000,-9217,1728406813,1728440031
6128,30000,73787,-43787,1728471799,1728548704
6129,38391,38402,-11,1728499808,1728565754
6130,40999,37700,3299,1728562500,1728563820
6131,38398,34500,3898,1728557574,1728537723
6133,4394,4208,186,1728502819,1728557594
6135,11975,11600,375,1728565206,1728564843
6137,150230,50000,100230,1728551481,1728531260
6139,36600,27000,9600,1728551424,1728563403
6141,26000,23600,2400,1728552285,1728565884
6143,4142,9376,-5234,1728412994,1728516945
6145,346,319,27,1728556047,1728551586
6147,152880,60005,92875,1728551469,1728536855
6149,2800,322,2478,1728541332,1728546107
6151,618,618,0,1728563664,1728535006
6153,199996,406338,-206342,1728515401,1728563698
6155,346,336,10,1728537957,1728565981
6157,10099,20000,-9901,1728553568,1728546821
6159,11542,17100,-5558,1728516374,1728471092
6161,19335,18666,669,1728080762,1728553482
6163,70785,55000,15785,1728479309,1728479360
6165,17904,18846,-942,1727842781,1728252221
6167,18087,35000,-16913,1727883480,1728276397
6169,20367,24754,-4387,1728135369,1728565721
6171,10401,7984,2417,1728540285,1728525144
6173,686,5650,-4964,1728537924,1727984195
6211,3408,1700,1708,1728529304,1728565641
6213,2777,1942,835,1728516738,1728513272
6215,3603,25472,-21869,1728543892,1728513657
6235,9998,6493,3505,1728559902,1728561242
6237,1853,1127,726,1728543825,1728544035
6257,5578,6360,-782,1728551166,1728427372
6259,1625,1412,213,1728556140,1728560116
6279,9999,1200,8799,1728561189,1728553914
6281,1,5,-4,1728559098,1728485463
6283,950,8,942,1728506849,1728563003
6285,3157,50,3107,1728498918,1728557921
6287,94,15,79,1728564674,1728506399
6289,13,13,0,1728565621,1728565810
6291,295,205,90,1728565084,1728564421
6297,8998,331,8667,1728535550,1728552245
6299,4900,231,4669,1728473093,1728556795
6305,195,125,70,1728563903,1728555854
6306,10,10,0,1728565733,1728564045
6311,649999,650272,-273,1728565611,1728561486
6313,467,1537,-1070,1728564702,1728564837
6315,25000,10000,15000,1728561778,1728512812
6317,29900,20484,9416,1728565871,1728564615
6319,700,406,294,1728561802,1728565177
6322,573,401,172,1728564523,1728565825
6324,1000,549,451,1728565543,1728565960
6326,530,337,193,1728565758,1728565140
6328,239,199,40,1728565893,1728565801
6330,1000,414,586,1728564111,1728564541
6332,535,526,9,1728565940,1728565994
6333,319,317,2,1728565790,1728565837
6335,6000,4277,1723,1728562992,1728565982
6337,4098,6354,-2256,1728447091,1728562866
6339,5484,2154,3330,1728562985,1728565985
6341,15000,8561,6439,1728527507,1728565188
6343,1000,69,931,1728439087,1728371869
6345,100000,3250,96750,1728430416,1728555730
6347,1000,69,931,1728439094,1728412476
6349,11999,4025,7974,1728547208,1728556822
6351,20000,20000,0,1728529898,1728528499
6353,64000,5367,58633,1728501379,1728509848
6355,3531,15000,-11469,1728021479,1728450164
6357,50000,10000,40000,1728457817,1728565945
6359,15077,935,14142,1728437018,1727659341
6361,2869,4103,-1234,1728483184,1728508941
6363,2367,69,2298,1728394514,1728450116
6365,3526,3711,-185,1728535539,1728522451
6367,2551,500,2051,1728472459,1728510427
6369,16879,2700,14179,1728338873,1728262563
6371,4477,250,4227,1728564860,1728504198
6373,68000,5500,62500,1728233880,1728238014
6375,2616,69,2547,1728535239,1728387546
6377,1198,750,448,1728565707,1728510436
6379,65000,3808,61192,1728323941,1728238036
6382,2200,1015,1185,1728563699,1728562149
6384,647,638,9,1728550231,1728558686
6386,541,272,269,1728565455,1728565480
6388,770,770,0,1728564619,1728536289
6390,1002,1393,-391,1728564707,1728384145
6392,1817,100,1717,1728564248,1728563237
6394,1827,900,927,1728564310,1728563248
6396,4580,781,3799,1728564326,1728563264
6398,3349,2065,1284,1728553482,1728563820
6400,450,100,350,1728562680,1728508606
6402,10000,10000,0,1728564954,1728518846
6404,439,100,339,1728555878,1728513587
6406,140,100,40,1728564841,1728481611
6408,2500,1708,792,1728503810,1727979633
6410,708,1361,-653,1728506786,1727270206
6412,1748,28833,-27085,1728500623,1728338570
6414,1329,1329,0,1728556316,1728130305
6416,2868,2868,0,1728564698,1728554766
6418,992,1507,-515,1728565882,1728551671
6420,1080,401,679,1728563960,1728532558
6470,1,1,0,1728565309,1728563555
6472,1,1,0,1728565763,1728556412
6474,1,5,-4,1728428610,1728085941
6476,12,3,9,1728512676,1728529221
6522,3985,3068,917,1728562877,1728565140
6523,423161,407614,15547,1728564920,1728565800
6524,523078,502940,20138,1728565445,1728565877
6525,87400,74800,12600,1728547636,1728528613
6526,432232,390000,42232,1728559994,1728548604
6527,332475,261184,71291,1728559982,1728531652
6528,491529,471350,20179,1728565962,1728565793
6562,27995,21111,6884,1728565777,1728565914
6563,89993,55000,34993,1728565489,1728558536
6568,634618,633178,1440,1728565893,1728565910
6571,2550000,2511723,38277,1728564448,1728565235
6573,2550000,2456251,93749,1728560029,1728565423
6575,2000000,1660004,339996,1728437102,1728316848
6577,2824347,2439779,384568,1728238211,1728515392
6579,2186675,2300000,-113325,1719607024,1727739325
6581,2654122,2793812,-139690,1728548364,1728532918
6583,1444459,1401000,43459,1728561599,1728562203
6585,2557548,2522599,34949,1728565938,1728565959
6587,400,5,395,1728545100,1728260617
6589,49999,4074,45925,1728286762,1728556440
6591,5000,237,4763,1728545394,1727889990
6593,86,199,-113,1727560028,1724189444
6595,390000,350,389650,1728164632,1728198546
6597,431,411,20,1728271187,1728097832
6599,1000000,10000,990000,1728462528,1728539620
6601,5000,598,4402,1728565903,1727828747
6603,5050,2653,2397,1728561580,1728563455
6605,1624,1709,-85,1728483401,1728544132
6607,954,100000,-99046,1728521138,1728457755
6609,1169,946,223,1728546082,1728558110
6611,997,250,747,1728495729,1728501189
6613,1589,1589,0,1728278849,1728352275
6615,1033,955,78,1728507410,1728512635
6617,8994,6001,2993,1728565824,1728565925
6619,2157,2157,0,1728563461,1728559630
6621,1411,2080,-669,1728191727,1728456553
6623,7999,7023,976,1728562899,1728563433
6625,8080,4000,4080,1728565839,1728565926
6627,2288,2408,-120,1728534157,1728562263
6629,9980,10000,-20,1728562164,1728565991
6631,3500,100,3400,1728500810,1728404643
6633,1870,1968,-98,1728562934,1728520694
6667,1,1,0,1728565941,1728559975
6681,50,20,30,1728552838,1728560957
6685,11811,11719,92,1728565999,1728565985
6687,8819,8700,119,1728565255,1728565961
6689,5661,4585,1076,1728563032,1728565621
6691,2831,2801,30,1728565405,1728565562
6693,7423,7400,23,1728565913,1728565971
6697,46,30,16,1728562916,1728556864
6701,347,213,134,1728544148,1728524284
6703,493,400,93,1728564878,1728531197
6705,395,353,42,1728565918,1728562864
6724,44997,38954,6043,1728565903,1728563451
6729,15527,15280,247,1728565594,1728565808
6731,452537,441000,11537,1728565387,1728565739
6733,2944000,2916008,27992,1728565853,1728565680
6735,74230,69036,5194,1728565892,1728565882
6737,4829000,4750000,79000,1728565871,1728565905
6739,57898,57333,565,1728565727,1728565890
6750,1450,201,1249,1728563910,1728563271
6752,3000,500,2500,1728561935,1728563276
6760,3443,5501,-2058,1728527489,1728561677
6762,3645,5551,-1906,1728526353,1728565396
6764,6500,5501,999,1728553511,1728565272
6794,313,300,13,1728456532,1728562013
6809,54374,43139,11235,1728565964,1728563991
6812,4134,4105,29,1728564940,1728565932
6814,396,360,36,1728565916,1728562143
6889,2137608,2076474,61134,1728565795,1728565977
6891,45000,1867,43133,1728544888,1728427481
6908,239999,185000,54999,1728560350,1728529944
6910,784445,677635,106810,1728563198,1728552207
6912,2019693,1969256,50437,1728552817,1728481548
6914,1916764,1894906,21858,1728565811,1728565255
6916,2578698,2428602,150096,1728565775,1728565797
6918,1168079,1149100,18979,1728563606,1728565951
6920,354000,350116,3884,1728565845,1728565787
6922,1100000,1117158,-17158,1728559369,1728562263
6924,2260000,2189237,70763,1728561257,1728565803
6959,7000,6877,123,1728536477,1728548989
6962,735,735,0,1728559684,1728564030
6971,1,2,-1,1728356182,1728564558
6973,33,33,0,1728564181,1728409194
6975,11,6,5,1728564043,1728556442
6977,2829,2829,0,1728564136,1728549585
6979,147,10,137,1728562235,1728461583
6981,26,4,22,1728564645,1728563019
6983,500,20,480,1728564061,1728564460
7051,2000,394,1606,1728564576,1728565040
7054,230,193,37,1728551945,1728565004
7056,233,204,29,1728554087,1728564886
7058,829,870,-41,1728523562,1728565893
7060,1600,1535,65,1728565649,1728565723
7062,30000,300,29700,1728517109,1728296827
7064,61,1,60,1728499179,1728272113
7066,15000,1000,14000,1727919865,1728162068
7068,998,800,198,1728544186,1728544192
7070,5000,307,4693,1728429603,1728437798
7072,50000,556,49444,1728521286,1728344885
7074,11500,350,11150,1728315496,1728380398
7076,5501,300,5201,1727741060,1728361261
7078,4899,80,4819,1727712963,1728507001
7080,2000,501,1499,1728400208,1728268663
7082,44,31,13,1728488292,1728565452
7084,6501,182,6319,1728093054,1728368734
7086,197,252,-55,1728519201,1728411367
7088,677,600,77,1728510049,1728541423
7110,937,876,61,1728565373,1728523262
7112,250,15,235,1728562391,1728563926
7114,1682,1500,182,1728561835,1728565953
7116,1000,464,536,1728366417,1728510451
7122,1053,946,107,1728548369,1728520055
7124,895,769,126,1728562406,1728564599
7126,639,325,314,1728549755,1728480303
7128,1,801,-800,1728546044,1728510459
7130,500,535,-35,1728556501,1728102701
7132,1000,783,217,1728516417,1728546600
7134,286,200,86,1728521571,1728510985
7136,1031,979,52,1728558782,1728542402
7138,1,655,-654,1728497385,1727629973
7158,132923,130801,2122,1728565302,1728565985
7159,999,420,579,1728564992,1728562987
7162,10,15,-5,1728385092,1728279469
7168,1900,1900,0,1728530968,1728512534
7170,2000,1450,550,1728564771,1728560978
7176,1249,1249,0,1728350296,1728286529
7178,260,125,135,1728565699,1728565649
7186,1799,1300,499,1728515566,1728516203
7188,900,411,489,1728564910,1728564571
7196,1489,1350,139,1728565094,1728565097
7198,133,112,21,1728565919,1728565698
7206,4009,4220,-211,1728564787,1728528136
7208,795,731,64,1728565431,1728565788
7216,1111,1120,-9,1728561444,1728564333
7218,797,785,12,1728565984,1728565389
7223,85,69,16,1728426747,1728516803
7225,389,295,94,1728565941,1728565611
7319,22103,21486,617,1728553403,1728558492
7321,5612,6000,-388,1728534946,1728565755
7323,7444,7500,-56,1728562658,1728564397
7325,6270,6300,-30,1728544753,1728563515
7327,9500,2851,6649,1728565338,1728556652
7329,75,78,-3,1728565835,1728565987
7330,249,151,98,1728562137,1728565847
7331,200,150,50,1728565988,1728565966
7332,3530,3530,0,1728545622,1728555239
7334,3200,2500,700,1728561010,1728565182
7336,70275,50501,19774,1728564268,1728564677
7338,5000,3501,1499,1728473034,1728553968
7340,2784,2645,139,1728562391,1728565144
7342,36051,34500,1551,1728564574,1728562143
7344,33000,1105,31895,1727951553,1728563289
7346,2754,2720,34,1728521202,1728540359
7348,33367,31800,1567,1728561361,1728559999
7350,45000,3501,41499,1728530502,1728546442
7352,2907,2352,555,1728529886,1728556534
7354,36999,33532,3467,1728563694,1728564289
7356,2515,2505,10,1728478208,1728560992
7358,3885,3544,341,1728547227,1728565748
7360,32595,32516,79,1728565521,1728564159
7362,40000,24111,15889,1728546247,1728547562
7364,50000,6156,43844,1728546695,1728560834
7366,10000,5000,5000,1728565786,1728547616
7368,15000,8625,6375,1728546680,1728560621
7370,5714,5548,166,1728559515,1728565972
7372,5286,5057,229,1728560685,1728564586
7374,19999,6864,13135,1728556171,1728564950
7376,5106,5106,0,1728456945,1728560653
7378,37000,34959,2041,1728563344,1728565879
7380,5504,5400,104,1728560248,1728558517
7382,89998,7000,82998,1728547230,1728561385
7384,25000,3500,21500,1728522746,1728559774
7386,21585,20506,1079,1728561168,1728564911
7388,25252,20133,5119,1728544372,1728554159
7390,154129,141000,13129,1728561179,1728564907
7392,29827,37481,-7654,1728552346,1728562629
7394,195219,190000,5219,1728558656,1728564916
7396,57500,54444,3056,1728561682,1728558938
7398,67575,60963,6612,1728565738,1728563268
7399,89057,82116,6941,1728565754,1728562852
7400,13000,12000,1000,1728561452,1728564904
7416,9922,9533,389,1728565720,1728565847
7418,9194,8918,276,1728565728,1728565845
7433,2000,2222,-222,1728503729,1728537347
7435,60,176,-116,1728489351,1728250536
7437,306,1000,-694,1728087658,1728537344
7439,606,1551,-945,1728325293,1728529995
7441,474,474,0,1728528116,1728526485
7443,1200,1200,0,1728285956,1728516210
7445,19000,15000,4000,1728564729,1728564305
7447,7258,2000,5258,1728564260,1728507679
7449,26281,23800,2481,1728464403,1728506045
7451,17367,22163,-4796,1728512867,1728481974
7468,1150,1150,0,1728563991,1728515853
7521,1472,1472,0,1728528772,1728495754
7566,799,395,404,1728562049,1728562731
7568,2004,1300,704,1728500687,1728551736
7650,500,12,488,1728565672,1728513682
7660,1900,328,1572,1728563985,1728565303
7662,1,58,-57,1728426811,1728544823
7664,458,209,249,1727914635,1725409119
7666,273,273,0,1728496615,1728484329
7668,2164,1701,463,1728565434,1728565442
7759,16250,5000,11250,1728394619,1728431888
7761,44999,3747,41252,1728441111,1728324397
7763,2761,1001,1760,1728528442,1728506871
7765,7325,4749,2576,1728555641,1728324357
7767,98594,2600,95994,1728506127,1728563388
7769,3921,3915,6,1728555553,1728554648
7771,3221,3175,46,1728547663,1728552792
7801,1,287,-286,1728534467,1728509357
7919,1111,1001,110,1728422956,1728549172
7936,1,2,-1,1728566001,1728551704
7939,7267,7000,267,1728565955,1728565961
7944,206,204,2,1728565145,1728565989
7946,345,335,10,1728565976,1728565826
8007,614,602,12,1728565970,1728565758
8008,555,535,20,1728565974,1728563699
8009,466,451,15,1728565995,1728565805
8010,546,528,18,1728565979,1728565795
8011,423,417,6,1728565783,1728565767
8012,649,596,53,1728565787,1728565422
8013,479,466,13,1728565995,1728565844
8014,481,351,130,1728563225,1728520548
8015,697,662,35,1728565837,1728565077
8016,55,36,19,1728561693,1728504789
8017,320,179,141,1728564169,1728519521
8018,2000,2000,0,1728564610,1728564859
8019,353,400,-47,1728506793,1728433512
8020,240,82,158,1728523251,1728446255
8021,539,622,-83,1728493232,1728433571
8417,2500,600,1900,1728561053,1728540679
8419,2726,2570,156,1728565722,1728559337
8421,6200,3507,2693,1728564025,1728565439
8423,11500,11001,499,1728564408,1728528958
8425,15700,14000,1700,1728564891,1728549790
8427,20000,15007,4993,1728565268,1728554348
8429,54304,69305,-15001,1728563891,1728551453
8431,1747,1571,176,1728564858,1728564281
8433,5569,5300,269,1728564873,1728564283
8435,12086,10160,1926,1728565473,1728564931
8437,4028,3000,1028,1728561811,1728553095
8439,11000,5002,5998,1728527615,1728435986
8441,21500,8001,13499,1728552805,1728441589
8443,29999,30380,-381,1728565731,1728495988
8445,35000,13500,21500,1728557223,1728537064
8447,65000,21100,43900,1728551854,1728540678
8449,100000,60000,40000,1728561711,1728441572
8451,7000,6172,828,1728538042,1728537053
8453,9634,8676,958,1728563974,1728564133
8455,16438,16438,0,1728563996,1728558447
8457,6114,6217,-103,1728563987,1728555671
8459,11043,6100,4943,1728564002,1728564130
8461,15818,15000,818,1728561236,1728546841
8496,1710,801,909,1728551648,1728555826
8498,900000,981,899019,1728199974,1728552972
8500,60,58,2,1728425452,1728524585
8502,5000,5000,0,1728555186,1728562830
8504,39,321,-282,1728552967,1728406011
8506,1000000,2000,998000,1728186584,1728564336
8508,104,104,0,1728362878,1728401999
8510,500,50,450,1728216698,1728524562
8512,55,55,0,1727480830,1728504527
8514,4999,25,4974,1728520414,1728401995
8516,1,121,-120,1728499056,1726554020
8518,24999,16000,8999,1728379182,1727528033
8520,9161,2000,7161,1728504828,1728557270
8522,14714,14714,0,1728514828,1728512506
8524,346,442,-96,1727008574,1723740764
8526,15812,25647,-9835,1728459866,1728198942
8528,1,1,0,1728524577,1728158204
8530,20000,110,19890,1724371782,1728534941
8532,36,82,-46,1728335822,1718737279
8548,3,6,-3,1721546471,1728535393
8550,8,16,-8,1724334827,1728504519
8552,2,2,0,1728505800,1728434117
8554,1,1,0,1728505554,1728250126
8556,247,10,237,1727946531,1726945913
8558,100,25,75,1728391515,1728541377
8560,1200000,1205000,-5000,1724712883,1727977161
8562,11,30,-19,1723479613,1728167517
8564,1,58,-57,1727700179,1719867901
8566,1,1,0,1728504542,1727313841
8568,1,1,0,1728505591,1714365694
8570,67,9,58,1728243585,1727835660
8572,1,104,-103,1728481761,1721571169
8574,550000,200000,350000,1727630125,1727535691
8576,909,1568,-659,1728563317,1727053351
8578,3436,4184,-748,1728563332,1727972774
8580,519,799,-280,1725768104,1725714029
8582,1565,7666,-6101,1728341133,1726734699
8584,1810,3668,-1858,1726881919,1728202900
8586,69420,23312,46108,1728446137,1728298859
8588,499994,300000,199994,1719342341,1727536176
8590,327,501,-174,1726792704,1728243552
8592,1714,1400,314,1727978488,1713313768
8594,140000,14222,125778,1728059777,1727824915
8596,12,10000,-9988,1721928645,1705258034
8598,85,85,0,1725624145,1727041913
8600,115,681,-566,1727629021,1709426532
8602,160,2000,-1840,1726452951,1714424338
8604,1000,407,593,1719560035,1719248883
8606,779,11248,-10469,1728501474,1725299885
8608,500000,200000,300000,1727583135,1727535183
8610,10,10,0,1720395859,1727103494
8612,32,2,30,1728491186,1728234595
8614,1,11,-10,1728077629,1715027448
8616,1,1,0,1728501364,1722979333
8618,1,154,-153,1727927792,1720625868
8620,1052,50000,-48948,1728519392,1727925871
8622,217000,121189,95811,1727744395,1727837626
8778,673,680,-7,1728565898,1728566001
8780,1130,1123,7,1728565907,1728565930
8782,2381,2356,25,1728565794,1728565854
8784,136920,134585,2335,1728565951,1728565453
8786,331509,331509,0,1728565842,1728565460
8788,987046,972503,14543,1728565445,1728562178
8790,1000,938,62,1728565941,1728565388
8792,925,900,25,1728565823,1728565851
8794,402,379,23,1728565085,1728565744
8837,1165,950,215,1728564167,1728564236
8872,5932,3789,2143,1728565468,1728565590
8874,1750,3000,-1250,1728435038,1728488556
8876,5555,250,5305,1728518930,1727845367
8878,7999,7560,439,1728546978,1728557297
8880,2700,2628,72,1728565847,1728563506
8882,5,4,1,1728564425,1728564451
8901,738227,725158,13069,1728565216,1728565454
8921,747005,736000,11005,1728565876,1728565751
8924,614,1331,-717,1728534034,1727969551
8925,10000,2000,8000,1728431358,1728565430
8926,259,658,-399,1728517607,1728198886
8927,1716,1716,0,1728431240,1727613914
8928,124997,69996,55001,1728412966,1728529121
9003,400,800,-400,1728480418,1728564034
9004,288,30,258,1728559235,1728565059
9026,19000,1000,18000,1728564704,1728565833
9028,993,990,3,1728563777,1728565768
9030,182,174,8,1728564887,1728564820
9032,449,144,305,1728528824,1728550633
9034,1246,1240,6,1728564889,1728564408
9036,125,95,30,1728564980,1728565964
9038,194,194,0,1728564955,1728565641
9040,745,745,0,1728565780,1728564880
9042,149,149,0,1728565783,1728564602
9044,4999999,4903640,96359,1651055388,1651055179
9050,5097888,5010000,87888,1651055356,1651055295
9052,43000,70,42930,1728521345,1728395734
9075,117,110,7,1728565992,1728565810
9140,20,15,5,1728563647,1728565175
9141,35,35,0,1728564365,1728560408
9142,59,56,3,1728565079,1728565966
9143,16,14,2,1728565145,1728565811
9144,48,47,1,1728565269,1728565974
9145,13,10,3,1728526347,1728562645
9174,694,550,144,1728565094,1728564326
9177,275,1,274,1728563596,1728516910
9179,202,50,152,1728557677,1728416937
9181,1329,1290,39,1728565216,1728564189
9183,3264,2900,364,1728565775,1728564303
9185,10449,10449,0,1728565991,1728565965
9187,10,10,0,1728558101,1728556871
9188,235,235,0,1728562719,1728565168
9189,7,3,4,1728565039,1728565635
9190,46,48,-2,1728558424,1728565810
9191,91,90,1,1728565931,1728565997
9192,163,162,1,1728565823,1728565977
9193,945,945,0,1728565961,1728566000
9194,8757,8632,125,1728565744,1728565996
9236,4,4,0,1728532377,1728546419
9238,23,5,18,1728509709,1728562492
9239,9,9,0,1728526045,1728563922
9240,12,11,1,1728565433,1728564428
9241,9,9,0,1728562545,1728565415
9242,49,48,1,1728565433,1728565845
9243,60,63,-3,1728565672,1728566000
9244,483,480,3,1728565872,1728565927
9245,8721,8721,0,1728565958,1728565984
9287,55,200000,-199945,1728565905,1728416460
9288,162,39992,-39830,1728320630,1726849700
9289,196,194,2,1728512840,1728416257
9290,194,150,44,1728515526,1728520979
9291,212,137,75,1728536546,1728511381
9292,44,48,-4,1728486412,1727659201
9294,150,38,112,1728411483,1723569005
9295,11,11,0,1728142238,1728142220
9296,528,111,417,1728496186,1727888468
9297,383,253,130,1728531862,1728506753
9298,326,119,207,1728532915,1728542712
9299,1254,1321,-67,1728416106,1728142487
9301,314,948,-634,1727674639,1727805478
9302,732,694,38,1724892675,1728515042
9303,2500,2021,479,1728371287,1728406702
9304,1090,900,190,1728461525,1728505377
9305,1250,910,340,1728551230,1728564167
9306,31000,31000,0,1728440147,1728440147
9336,309,230,79,1728563720,1728563386
9337,80,58,22,1728564027,1728563591
9338,109,114,-5,1728565895,1728565172
9339,117,112,5,1728565668,1728565332
9340,187,189,-2,1728564469,1728565867
9341,996,991,5,1728565715,1728565575
9342,8884,8849,35,1728565476,1728565904
9375,12,12,0,1728564596,1728563540
9377,21,11,10,1728422842,1728558225
9378,57,55,2,1728563094,1728563461
9379,86,76,10,1728565687,1728565915
9380,86,85,1,1728565493,1728565464
9381,99,101,-2,1728558151,1728565938
9382,24,8,16,1728535437,1728389649
9416,332,200,132,1728540538,1728508467
9418,3333,1250,2083,1728563942,1728564131
9419,1461,1444,17,1728565869,1728563352
9420,55,51,4,1728542739,1728554308
9423,51,100,-49,1727725851,1728541610
9425,101,100,1,1728441432,1728335612
9427,505,527,-22,1728534122,1728554898
9429,1602,1766,-164,1728309255,1728541435
9431,9361,9361,0,1728561940,1728565989
9434,1,12,-11,1728547960,1728535453
9436,238,232,6,1728563571,1728559651
9438,464,464,0,1728550110,1728563764
9440,5,5,0,1728562606,1728556853
9442,40,10,30,1728550900,1728564888
9444,256,12,244,1728122008,1728549103
9446,44,44,0,1728549369,1728546599
9448,6,10,-4,1728542147,1728565798
9450,50,100,-50,1728415176,1728565321
9452,186,114,72,1728562102,1728565817
9454,80,120,-40,1728546785,1728541679
9457,69,69,0,1728310699,1727634208
9459,19995,119,19876,1728336510,1728427847
9461,1100,710,390,1728536932,1728519293
9463,2094,1846,248,1728555488,1728554172
9465,9639,9625,14,1728563482,1728565931
9469,200000,181000,19000,1728564872,1728564055
9470,897891,811216,86675,1728565536,1728565642
9472,44641,60000,-15359,1728562044,1728540592
9475,197270,187407,9863,1728528953,1728563881
9629,1968,1543,425,1728553053,1728556099
9634,3500,3500,0,1728565492,1728552627
9636,3994,3300,694,1728565530,1728552734
9638,4000,4000,0,1728565501,1728552642
9640,661,1,660,1728447271,1728509758
9642,15000,2500,12500,1728499257,1728391528
9644,724,1568,-844,1728558226,1728248783
9666,26612,25000,1612,1728548259,1728544781
9668,30000,24049,5951,1728564776,1728538612
9670,29108,27740,1368,1728564941,1728526683
9672,8398,4294,4104,1728565804,1728565948
9674,6649,6314,335,1728564959,1728565941
9676,5735,5470,265,1728565052,1728565944
9678,5631,5400,231,1728562338,1728562387
9729,340,50000,-49660,1728450675,1728517804
9731,43066,43036,30,1728565894,1728565819
9733,6666,6666,0,1728564707,1728565740
9735,50,45,5,1728565871,1728565721
9736,100,85,15,1728565755,1728564489
9739,322,300,22,1728565729,1728560343
9741,174,211,-37,1728560710,1728565937
9743,90,80,10,1728534093,1728561378
9745,38,44,-6,1728513768,1728563817
9843,25000,1000,24000,1728466462,1728556268
9844,99000,1000,98000,1728466526,1727535665
9845,1088,590,498,1728527994,1727050369
9846,189000,180000,9000,1728414982,1728171097
9847,388837,220000,168837,1728477369,1727535102
9848,1298900,820731,478169,1728340267,1726972674
9849,17,17,0,1727207156,1727069290
9850,39000,1000,38000,1728111491,1727535631
9851,4968,2551,2417,1728450109,1728344003
9852,19,73,-54,1728380796,1727742239
9853,1,1000,-999,1728542837,1725854120
9854,48,500,-452,1726776119,1728488713
9855,400,36,364,1728542872,1724905748
9856,5000,5000,0,1728561850,1728542949
9857,490000,200000,290000,1728425472,1727932299
9858,498990,450000,48990,1728514422,1728428408
9859,18,19,-1,1728466272,1727992112
9860,4999,200,4799,1728526170,1728513728
9861,3508,4262,-754,1728561804,1727008545
9862,24,24,0,1728126671,1727235685
9863,170,150000,-149830,1725979448,1727535639
9864,3125,1000,2125,1728552878,1727212287
9865,18,454,-436,1728228189,1724867983
9866,231,50000,-49769,1728279468,1728444075
9867,2116,2991,-875,1728552953,1727848522
9978,35,35,0,1728565867,1728565468
9980,16,200,-184,1728008792,1728534778
9986,7,7,0,1728565456,1728566001
9988,6,52,-46,1728490569,1727676190
9994,415,500,-85,1728525594,1728493417
9996,4000,500,3500,1728525122,1728559451
9998,4420,4230,190,1728565887,1728565787
10000,2241,2023,218,1728563371,1728558494
10002,1456,463,993,1728561810,1728539887
10004,1461,1610,-149,1728519479,1728547897
10006,32,19,13,1728565913,1728565416
10008,55,29,26,1728565922,1728565924
10010,113,73,40,1728565739,1728559672
10012,300,250,50,1728565834,1728565988
10014,300,285,15,1728564777,1728564606
10016,868,305,563,1728564806,1728554276
10018,693,1000,-307,1728463962,1728562615
10020,273,962,-689,1728519905,1728564162
10025,460,350,110,1728550199,1728548606
10029,5,3,2,1728565130,1728562041
10031,200,10,190,1728545006,1728565189
10033,879,857,22,1728565760,1728565931
10034,1879,1868,11,1728565983,1728565966
10035,411,276,135,1728564128,1728536012
10037,2000,10,1990,1728565395,1728565430
10039,1399,205,1194,1728563018,1728548397
10041,10000,10000,0,1728564694,1728557469
10043,3000,5,2995,1728557447,1728549581
10045,2209,2209,0,1728556947,1728564263
10047,1083,177,906,1728560532,1728548390
10049,1366,580,786,1728560546,1728522475
10051,2473,67,2406,1728560556,1728475749
10053,7564,1700,5864,1728540599,1728553862
10055,5076,5920,-844,1728564702,1728528093
10057,4600,795,3805,1728565251,1728546014
10059,1000,969,31,1728565260,1728541859
10061,6999,1000,5999,1728542692,1728548374
10063,6854,15,6839,1728564666,1728483430
10065,9419,2873,6546,1728562993,1728564530
10067,11000,5300,5700,1728564681,1728564760
10069,958,922,36,1728565190,1728565014
10071,1168,630,538,1728565202,1728559069
10075,1777,1277,500,1728565548,1728562383
10077,200,10,190,1728133713,1728538863
10079,1681,1000,681,1728531832,1728546945
10081,1829,1300,529,1728532086,1728547823
10083,1707,1735,-28,1728554254,1728565994
10085,2868,2309,559,1728560000,1728558668
10087,10,10,0,1728563060,1728564066
10088,10,16,-6,1728544717,1728563119
10089,145,150,-5,1728532261,1728565471
10090,150,150,0,1728537367,1728564424
10091,23,5,18,1728561072,1728565638
10093,391,403,-12,1728549301,1728430419
10095,247,200,47,1728562696,1728565906
10097,103,100,3,1728549291,1728564453
10099,451,301,150,1728562766,1728565985
10101,316,175,141,1728540791,1728565182
10103,500,271,229,1728563359,1728565915
10105,633,605,28,1728506712,1728565953
10107,744,817,-73,1728526733,1728565375
10109,364,362,2,1728559508,1728565619
10111,495,415,80,1728561944,1728564431
10113,100,90,10,1728546936,1728536494
10115,116,116,0,1728565832,1728563651
10117,4000,2301,1699,1728563552,1728565817
10119,111,111,0,1728553494,1728564128
10121,1213,1213,0,1728559189,1728565885
10123,1182,1000,182,1727888618,1728455884
10125,47,47,0,1728565826,1728565969
10127,119,108,11,1728565445,1728564604
10129,7000,300,6700,1728565899,1728556520
10132,2701,2063,638,1728565335,1728553894
10134,1425,5641,-4216,1728545973,1728478735
10136,5000,250,4750,1728528254,1728564005
10138,601,527,74,1728562863,1728531778
10142,1,2,-1,1728558530,1728538274
10143,3,2,1,1728562634,1728563576
10144,1,1,0,1728563656,1728562363
10145,1,1,0,1728565770,1728553627
10146,186,169,17,1728562500,1728565848
10147,36,79,-43,1728543308,1728565780
10148,821,593,228,1728564441,1728565765
10149,147,179,-32,1728565511,1728562604
10150,1,4,-3,1728565135,1728524390
10156,2275,1598,677,1728565564,1728565426
10158,57,56,1,1728565583,1728565185
10159,109,125,-16,1728541460,1728556110
10280,4000,3512,488,1728563834,1728562349
10282,6999,1920,5079,1728562989,1728565638
10284,3534,3345,189,1728565270,1728565531
10286,48000,42001,5999,1728564949,1728563361
10288,30016,30000,16,1728563712,1728557319
10290,28298,21501,6797,1728557133,1728561890
10292,25041,26233,-1192,1728565868,1728561761
10294,27500,24000,3500,1728563161,1728558201
10296,2943,3100,-157,1728537721,1728563456
10298,2268,2031,237,1728529013,1728556589
10300,10000,5666,4334,1728548791,1728565309
10302,2768,2500,268,1728560259,1728561627
10304,2847,2750,97,1728529484,1728558536
10306,1762,1521,241,1728551276,1728562372
10308,1471,1250,221,1728515699,1728551502
10310,3857,3738,119,1728561936,1728550285
10312,3888,2750,1138,1728506467,1728562415
10314,17000,5432,11568,1728542609,1728559034
10316,43210,30582,12628,1728565779,1728561030
10318,98222,35000,63222,1728562182,1728558931
10320,66500,35000,31500,1728558414,1728556814
10322,71900,50504,21396,1728563624,1728547608
10324,17000,15000,2000,1728564521,1728523245
10326,75,75,0,1728565654,1728565822
10327,244,79,165,1728565290,1728565986
10330,90000000,86666666,3333334,1728525719,1728538092
10332,61000000,56208669,4791331,1728525745,1728539130
10334,41000000,40101101,898899,1728525732,1728558066
10336,43222222,41111111,2111111,1728525760,1728523547
10338,267647435,262502003,5145432,1728526691,1728565720
10340,84555555,82563244,1992311,1728556098,1728565104
10342,46489996,45500001,989995,1728554998,1728565847
10344,176450000,173000000,3450000,1728541153,1728529602
10346,182250000,179796000,2454000,1728552673,1728529993
10348,394301257,390111111,4190146,1728552655,1728535796
10350,94997997,92502003,2495994,1728536573,1728535688
10352,239888000,236000000,3888000,1728559732,1728556954
10354,49226,57126,-7900,1728512806,1728565206
10362,81111,54004,27107,1728531116,1728561596
10364,49108,48500,608,1728565841,1728565029
10366,21077,21009,68,1728564855,1728565428
10368,169999,135006,34993,1728565520,1728564439
10370,294999,274638,20361,1728565984,1728565736
10372,548757,528800,19957,1728565691,1728565267
10374,71968,70000,1968,1728565321,1728564750
10376,32005,18507,13498,1728564872,1728565546
10378,182756,178035,4721,1728565767,1728564471
10380,302617,298302,4315,1728564851,1728565713
10382,74079,72130,1949,1728564889,1728565991
10384,60000,50000,10000,1728565874,1728565366
10386,205434,202549,2885,1728564579,1728565488
10388,396606,388168,8438,1728565505,1728565737
10390,93996,75356,18640,1728565598,1728565481
10392,11000,11252,-252,1728493381,1728557805
10394,4000000,3956362,43638,1728565507,1728561680
10396,7000,6508,492,1728527236,1728552113
10398,74000,50000,24000,1728551444,1728547437
10400,7162,10007,-2845,1728564252,1728556670
10402,8900,1501,7399,1728564259,1728526379
10404,8272,7700,572,1728557346,1728565989
10406,5412,4000,1412,1728557373,1728547077
10408,25441,18834,6607,1728562717,1728549109
10410,24000,20827,3173,1728562728,1728563740
10412,16753,2200,14553,1728557363,1728547218
10414,24000,1925,22075,1728557357,1728548365
10416,15000,5555,9445,1728562637,1728565078
10418,17000,5555,11445,1728562616,1728565502
10420,97333,72004,25329,1728545268,1728556631
10422,18198,19107,-909,1728545257,1728563839
10424,97000,55555,41445,1728431065,1728547560
10426,28500,20654,7846,1728520364,1728546445
10428,99000,44444,54556,1728542547,1728547398
10430,39000,20654,18346,1728554148,1728554186
10432,65000,46907,18093,1728490334,1728564553
10434,8005,20654,-12649,1728490433,1728548951
10436,45000,26755,18245,1728542641,1728550964
10438,23500,13031,10469,1728542592,1728553154
10440,19658,10000,9658,1728552187,1728561562
10442,12900,9510,3390,1728561603,1728558692
10444,12227,9000,3227,1728560404,1728563456
10446,99000,98000,1000,1728565620,1728565461
10448,40000,34350,5650,1728565910,1728565093
10450,64997,38500,26497,1728565712,1728564465
10452,21616,23511,-1895,1728564931,1728565776
10454,20229,20005,224,1728565961,1728565869
10456,28996,16756,12240,1728563361,1728565176
10458,188000,144502,43498,1728565783,1728565521
10460,119550,83403,36147,1728562548,1728564066
10462,59999,51497,8502,1728564832,1728565516
10464,179997,142010,37987,1728565774,1728564012
10466,50603,53266,-2663,1728562595,1728565530
10468,49811,65475,-15664,1728565654,1728564005
10470,14500,5049,9451,1728561718,1728565032
10472,3521,505,3016,1728563929,1728554134
10474,7610,5153,2457,1728555322,1728563484
10476,12327,12058,269,1728565690,1728565982
10496,1563,814,749,1728565955,1728561947
10564,61505,54001,7504,1728565382,1728565824
10589,48000,26638,21362,1728565964,1728565575
10808,2554,2433,121,1728526867,1728505523
10810,300,300,0,1728565855,1728565591
10812,850,610,240,1728565995,1728565539
10814,999,439,560,1728522873,1728565769
10816,95,5,90,1728564390,1728500330
10818,238,5,233,1728560632,1728495885
10820,288,40,248,1728554990,1728531314
10822,1300,977,323,1728565955,1728564477
10824,100,70,30,1728565989,1728564824
10826,2789,1930,859,1728565949,1728565529
10828,50979,50296,683,1728565937,1728565861
10891,3385,3382,3,1728564438,1728529935
10925,16693,16693,0,1728565988,1728565991
10927,15711,13575,2136,1728554670,1728564203
10929,12018,7629,4389,1728474200,1728565096
10931,5067,3800,1267,1728557736,1728562336
10937,818,816,2,1728565375,1728565474
10952,126,126,0,1728565451,1728563703
10954,668,654,14,1728553652,1728562933
10956,282,282,0,1728542551,1728562476
10958,445,400,45,1728547221,1728562491
10973,94,75,19,1728565306,1728565245
10978,4001,750,3251,1728156431,1728547775
10981,1108,906,202,1728565136,1728564928
10999,250,500,-250,1728555228,1728540435
11037,270000,267469,2531,1728565966,1728565795
11061,8600,5435,3165,1728564789,1728565810
11065,321,301,20,1728565840,1728565409
11069,259,256,3,1728564208,1728565257
11072,585,585,0,1728550542,1728565936
11074,764,560,204,1728523084,1728564694
11076,800,808,-8,1728564298,1728565842
11079,980,790,190,1728563986,1728563441
11085,1205,1232,-27,1728563088,1728565879
11088,1320,1220,100,1728556526,1728565645
11090,2546,2489,57,1728565479,1728565551
11092,2047,2046,1,1728565835,1728565685
11095,2278,2255,23,1728563849,1728561931
11105,12598,12060,538,1728565793,1728565746
11113,12073,12073,0,1728565712,1728565941
11115,11800,11750,50,1728565388,1728565830
11118,12481,12255,226,1728565945,1728565827
11126,12277,12278,-1,1728565887,1728565997
11128,2299963,2284426,15537,1728565685,1728564968
11130,2561866,2561866,0,1728482702,1728482701
11133,2586999,2532087,54912,1728565896,1728565847
11200,36263,35867,396,1728564956,1728565882
11205,557,780,-223,1728558171,1728443641
11212,1449,1436,13,1728565975,1728565985
11227,2124,2023,101,1728565694,1728565958
11228,2784,1673,1111,1728547478,1728563969
11229,2625,2583,42,1728565042,1728564570
11230,2199,2139,60,1728565954,1728565443
11231,2521,1750,771,1728541031,1728555862
11232,2569,2477,92,1728565105,1728565999
11233,2502,2133,369,1728533488,1728532066
11234,3151,3054,97,1728560769,1728564750
11235,1481860,1414676,67184,1728565914,1728565941
11237,1588,1572,16,1728565292,1728565914
11238,2891,2913,-22,1728565891,1728565528
11240,3476,3422,54,1728564826,1728565537
11242,5736,5669,67,1728565633,1728565917
11244,3036,2820,216,1728565707,1728565874
11246,3868,3812,56,1728565793,1728565938
11248,5914,5918,-4,1728565897,1728565892
11250,9609,9571,38,1728563917,1728565972
11252,36826,36183,643,1728565833,1728566001
11254,69000,68801,199,1728564789,1728565906
11256,534885,530321,4564,1728558154,1728565947
11260,1391,1386,5,1728565986,1728565850
11280,115000,82000,33000,1728537526,1728551082
11284,4150899,4200000,-49101,1728565909,1728565671
11286,4139998,4080000,59998,1728553388,1728564097
11324,450,100,350,1728565613,1728565108
11326,231,220,11,1728565526,1728565651
11328,8,8,0,1728565219,1728565697
11330,20,18,2,1728511389,1728565689
11332,69,40,29,1728554009,1728565692
11334,44,17,27,1728559043,1728557588
11335,72749275,70111339,2637936,1728564612,1728551521
11367,2071,200,1871,1728487543,1728560834
11369,100,100,0,1728533419,1728556779
11371,99,5,94,1728503918,1728556775
11373,259,210,49,1728512505,1728522687
11375,1200,1000,200,1728539770,1728563615
11377,12021,12005,16,1728564750,1728565621
11379,4092,139000,-134908,1728389907,1721693780
11382,1,5439,-5438,1728298862,1711619833
11384,1,6011,-6010,1728261407,1724545562
11386,1381,3,1378,1725062858,1728384371
11389,3029,1,3028,1727512746,1727734681
11391,3519,2726,793,1726905073,1727510364
11393,1,1,0,1728182772,1728182772
11396,1000,2,998,1728368768,1725911281
11398,1045,100,945,1728369270,1726447941
11400,1309,250,1059,1727951559,1720069936
11403,5000,3000,2000,1727840116,1722377412
11405,5000,9056,-4056,1728414376,1720128611
11407,5023,5023,0,1727888856,1728095825
11410,2365,3,2362,1728109411,1727889792
11412,49999,7233,42766,1728418891,1728357851
11414,5000,8650,-3650,1727834279,1727827036
11417,22114,18310,3804,1728418023,1728374813
11419,18337,22921,-4584,1728522618,1728440321
11429,16000,67,15933,1728552555,1728560675
11431,12,164,-152,1727881523,1728536204
11433,139,146,-7,1728556766,1728475674
11435,217,290,-73,1728134163,1727946341
11437,245,518,-273,1728436593,1726493218
11439,9999,10000,-1,1726451641,1711070295
11441,120,290,-170,1728317052,1727579703
11443,57,62,-5,1728544710,1728526009
11445,220,150,70,1728517027,1728513115
11447,289,320,-31,1728177177,1723858940
11449,300,155,145,1728480163,1728370065
11451,98,61,37,1728228269,1728535968
11453,1000,652,348,1728436631,1728370083
11455,190,18,172,1728015001,1727643931
11457,300,78,222,1727682948,1728329190
11459,21,22,-1,1722781945,1719243900
11461,875,309,566,1728541283,1728565670
11463,343,491,-148,1727637712,1728443314
11465,4375,4375,0,1728547955,1728562149
11467,2051,2051,0,1728126959,1728560501
11469,256,1023,-767,1728424274,1728552513
11471,241,200,41,1728521976,1728563697
11473,870,870,0,1728564053,1728544062
11475,35000,441,34559,1728279708,1728544260
11477,3000,100,2900,1728509936,1728540270
11479,72,72,0,1728245345,1726241372
11481,1985,4068,-2083,1728161781,1728523438
11483,896,992,-96,1727893132,1727919949
11485,900,900,0,1728563792,1728563580
11487,447,450,-3,1728539645,1728540329
11489,1949,12393,-10444,1728519756,1728494719
11491,384,1597,-1213,1728305798,1727203511
11493,4593,5316,-723,1728419906,1728525868
11495,3688,2000,1688,1727579021,1728470522
11497,515,420,95,1728542198,1728552612
11499,325,170,155,1728539714,1728565950
11501,1076,1543,-467,1727815913,1728516323
11503,1151,1151,0,1728488874,1728222780
11505,500,221,279,1728491871,1728554668
11507,30,3,27,1728541315,1728530265
11509,1335,1401,-66,1728527898,1728564798
11511,10000,550,9450,1725130069,1728539929
11513,120,36,84,1728554047,1728511041
11515,118,40,78,1728522038,1728450027
11517,47000,3075,43925,1728311439,1728470527
11519,133,169,-36,1726871871,1724879190
11521,4000,2223,1777,1728449222,1728516684
11523,263,1,262,1728129792,1727123748
11785,53227655,53227655,0,1728565894,1728565977
11787,44000,38381,5619,1728563694,1728564422
11789,62953,50000,12953,1728565507,1728565029
11791,9799048,9589626,209422,1728559488,1728564703
11798,484048,487498,-3450,1728564261,1728553935
11802,12086935,11952439,134496,1728566001,1728565892
11804,15160736,15020000,140736,1728565521,1728565554
11806,40395000,39834324,560676,1728565946,1728565502
11808,16945102,16726877,218225,1728564204,1728565796
11810,11290248,11312122,-21874,1728546349,1728561610
11812,14500000,14400000,100000,1728557908,1728564775
11814,38998999,38800000,198999,1728563739,1728565397
11816,16989775,16415000,574775,1728505144,1728565926
11818,151234,151020,214,1728563805,1728565723
11820,155000,153505,1495,1728563800,1728565869
11822,155000,154252,748,1728563786,1728564773
11824,3006061,2944001,62060,1728556681,1728565967
11826,11844590,11762697,81893,1728564964,1728565013
11828,47289006,47111111,177895,1728565084,1728565371
11830,35509209,35311122,198087,1728565091,1728565367
11832,30666924,30284031,382893,1728565840,1728565965
11834,20354442,20176416,178026,1728565821,1728565931
11836,187000,178773,8227,1728565766,1728565902
11838,187779,184009,3770,1728565827,1728565721
11840,130000,127169,2831,1728565977,1728565835
11874,50,45,5,1728563386,1728560298
11875,37,25,12,1728565482,1728565388
11876,56,48,8,1728564712,1728565277
11889,3254541,3215802,38739,1728565910,1728565975
11902,44499,40100,4399,1728564560,1728565804
11905,780660,773599,7061,1728564945,1728564981
11908,41000,40280,720,1728565883,1728565794
11920,922670,916569,6101,1728565987,1728565522
11924,2276734,2245090,31644,1728564874,1728563185
11926,4062407,3980809,81598,1728565018,1728564747
11928,2800000,2731000,69000,1728563218,1728558214
11929,950000,968320,-18320,1728554764,1728565557
11930,175000,175000,0,1728524835,1728565320
11931,1110000,1100000,10000,1728562690,1728562530
11932,698470,671000,27470,1728565277,1728565289
11933,139000,135000,4000,1728563040,1728565294
11934,1370,1304,66,1728560151,1728564746
11936,1642,1613,29,1728565986,1728565949
11940,10,8,2,1728564183,1728565536
11943,6435,6361,74,1728565821,1728565767
11951,210,230,-20,1728565923,1728565875
11953,210,206,4,1728565654,1728565814
11955,198,80,118,1728565718,1728564385
11957,84,51,33,1728565998,1728564393
11959,4287,4260,27,1728565942,1728565906
11960,299,100,199,1728490203,1728429781
11962,1,85,-84,1728562526,1728075671
11964,73016,75000,-1984,1728565825,1728541837
11968,12540,12524,16,1728565987,1728565805
11972,12747,12747,0,1728565984,1728565972
11978,11200,11090,110,1728565997,1728565918
11980,13350,13225,125,1728566001,1728565678
11990,9875,8500,1375,1728531183,1728563079
11992,225,219,6,1728561963,1728565651
11994,38,38,0,1728564641,1728565773
11998,1995480,1942389,53091,1728564329,1728565962
12000,2094000,1976829,117171,1728565914,1728565220
12002,499999,483803,16196,1728565820,1728565992
12004,609821,600181,9640,1728565685,1728565731
12007,50000,25000,25000,1728564860,1728565305
12193,84569,55244,29325,1728561397,1728564094
12195,57000,47001,9999,1728561353,1728565276
12197,49997,36500,13497,1728563146,1728564693
12199,19056,7952,11104,1728562953,1728565092
12201,2499,2001,498,1728565551,1728562747
12203,25119,22005,3114,1728565845,1728565841
12205,58048,59555,-1507,1728552897,1728565381
12207,11000,11367,-367,1728552906,1728565383
12209,3021,3143,-122,1728477794,1728563907
12211,69000,62165,6835,1728558512,1728565378
12213,36618,35097,1521,1728559096,1728564301
12215,4575,4575,0,1728555939,1728547118
12217,80000,8000,72000,1728462632,1728547558
12219,3351,3355,-4,1728549098,1728561133
12221,5468,5500,-32,1728554372,1728550700
12223,8850,8957,-107,1728506350,1728547007
12225,61178,62610,-1432,1728535967,1728563897
12227,35000,14749,20251,1728508749,1728561247
12229,3125,8000,-4875,1728534543,1728556562
12231,22350,27899,-5549,1728555377,1728562709
12233,30315,24000,6315,1728538121,1728559977
12235,257423,255000,2423,1728561892,1728553054
12237,25105,35629,-10524,1728561916,1728547549
12239,4467,3424,1043,1728561882,1728565739
12241,189235,176715,12520,1728561872,1728561928
12243,121558,131000,-9442,1728530668,1728560010
12245,30000,20016,9984,1728550528,1728564492
12247,19444,555,18889,1728564185,1728551534
12249,1674,5000,-3326,1728545668,1728547408
12251,31000,30000,1000,1728565476,1728547729
12253,70000,51001,18999,1728564602,1728563900
12255,62953,46000,16953,1728564574,1728564398
12257,17000,16886,114,1728564705,1728564799
12259,19000,13800,5200,1728564821,1728563415
12261,49997,39000,10997,1728565674,1728564726
12263,16000,7186,8814,1728558589,1728556669
12265,69797,51739,18058,1728564685,1728563798
12267,60000,44000,16000,1728552399,1728560842
12269,5776,3618,2158,1728564985,1728565374
12271,19096,24767,-5671,1728564262,1728564301
12273,130000,100368,29632,1728565776,1728564718
12275,7147,7066,81,1728563911,1728556703
12277,7888,8000,-112,1728557801,1728564945
12279,7000,4000,3000,1728560442,1728561979
12281,5932,5794,138,1728534699,1728560151
12283,5609,5377,232,1728565464,1728562286
12285,2352,1001,1351,1728531595,1728561757
12287,4376,4001,375,1728547645,1728565312
12289,3618,3444,174,1728539518,1728565350
12291,3701,5000,-1299,1728487652,1728559945
12293,3368,3368,0,1728547134,1728559940
12295,2284,2333,-49,1728443270,1728565068
12297,8000,3064,4936,1728565898,1728565519
12299,2127,3500,-1373,1728555470,1728552915
12301,2939,1622,1317,1728565811,1728559686
12303,1194,3500,-2306,1728557183,1728565769
12305,2119,3500,-1381,1728543009,1728565948
12307,3230,3500,-270,1728561850,1728563958
12309,7656,6100,1556,1728541704,1728562815
12311,8049,8000,49,1728561894,1728565293
12313,1500,5000,-3500,1728542818,1728564710
12315,2682,2511,171,1728528648,1728565146
12317,35000,18000,17000,1728529335,1728565504
12319,2826,2600,226,1728544091,1728565012
12321,14999,10526,4473,1728565298,1728558185
12323,4747,3000,1747,1728564406,1728554190
12325,9999,5897,4102,1728563111,1728564885
12327,7042,6104,938,1728561084,1728563496
12329,11111,10677,434,1728561069,1728565624
12331,8885,6751,2134,1728535644,1728564275
12333,3027,2400,627,1728552115,1728560266
12335,675000,512777,162223,1728555759,1728565990
12337,1445000,1331352,113648,1728523723,1728536444
12339,34724,47115,-12391,1728503477,1728562214
12341,19570,31614,-12044,1728514874,1728565994
12343,32000,16480,15520,1728531179,1728565023
12345,10000,2288,7712,1728561705,1728552736
12347,5000,2213,2787,1728523122,1728543600
12349,3075,5000,-1925,1728523128,1728556595
12351,96661,112739,-16078,1728565422,1728560449
12353,9312,14657,-5345,1728534114,1728562897
12355,596956,580420,16536,1728516334,1728545503
12357,159987,151917,8070,1728534217,1728558721
12359,18499,16637,1862,1728555997,1728564965
12361,26997,19748,7249,1728560419,1728562893
12363,3639,5600,-1961,1728531716,1728565027
12365,5701,5600,101,1728534086,1728564661
12367,5704,7021,-1317,1728548588,1728563651
12369,5775,5650,125,1728564322,1728564765
12371,3146723,3010011,136712,1728545307,1728552930
12373,25800,25606,194,1728537685,1728561492
12375,44500,18519,25981,1728564297,1728548639
12377,2005,1401,604,1728560136,1728565648
12379,100000,8205,91795,1728538172,1728562942
12381,21836,18000,3836,1728560033,1728563118
12383,191673,167891,23782,1728565910,1728561054
12385,10648,7282,3366,1728561571,1728562257
12387,23478,32000,-8522,1728563218,1728564188
12389,20237000,20237000,0,1728565893,1728565900
12391,1873991,1700000,173991,1728564051,1728563323
12393,50905,31314,19591,1728561692,1728534798
12395,19326,11000,8326,1728561682,1728561451
12397,139000,85499,53501,1728561666,1728555438
12399,1411123,1365990,45133,1728564442,1728565307
12402,26792,26500,292,1728565896,1728565699
12403,16945,15644,1301,1728565839,1728565813
12404,1926,1501,425,1728565955,1728565050
12405,4010,3616,394,1728565812,1728565738
12406,44124,43500,624,1728565881,1728565744
12407,636,362,274,1728565881,1728565834
12408,9225,8996,229,1728565814,1728565910
12409,6155,5526,629,1728565778,1728565501
12410,3321,3318,3,1728565995,1728565987
12411,2559,2520,39,1728565818,1728565805
12412,640000,530000,110000,1728516588,1728554303
12422,1089999999,1060009999,29990000,1728491679,1728419238
12424,2147483647,2147483647,0,1728558962,1728278839
12426,2147483647,2147483647,0,1727631738,1728073291
12428,20000,13143,6857,1728560550,1728565750
12430,148910,151004,-2094,1728545426,1728537973
12432,299996,120000,179996,1728536555,1728554057
12434,154801,121012,33789,1728564917,1728564948
12437,918999997,905708901,13291096,1728491797,1728506633
12439,21000,223,20777,1728561702,1728549566
12441,35187,35001,186,1728535783,1728554586
12443,15000,5819,9181,1728550108,1728541216
12445,58749,36326,22423,1728561138,1728553572
12447,12369,1032,11337,1728562312,1728553711
12449,218027,193444,24583,1728555340,1728564289
12451,62500,59922,2578,1728564192,1728565885
12453,339131,338168,963,1728564098,1728564217
12455,169999,165046,4953,1728560652,1728562304
12460,38584,38250,334,1728544796,1728565686
12462,37428,38585,-1157,1728565916,1728563799
12464,38113,36000,2113,1728538638,1728564209
12466,50000,29000,21000,1728544787,1728562476
12468,45716,43000,2716,1728562881,1728559679
12470,38642,38631,11,1728562388,1728565364
12472,38902,38550,352,1728564823,1728564964
12474,37764,37500,264,1728564713,1728562595
12476,22965,22970,-5,1728557734,1728565586
12478,33240,36564,-3324,1728562732,1728565871
12480,171000,164555,6445,1728565768,1728565603
12482,45000,37268,7732,1728548479,1728562909
12484,42000,39555,2445,1728530006,1728564161
12486,22364,22001,363,1728562338,1728557490
12488,35000,34055,945,1728521736,1728565292
12490,87787,81187,6600,1728565287,1728565760
12492,215837,206000,9837,1728565500,1728565948
12494,319942,300555,19387,1728565770,1728565973
12496,108135,98521,9614,1728565561,1728565946
12498,61612,58000,3612,1728565398,1728565963
12500,162852,154835,8017,1728565258,1728565952
12502,289116,285692,3424,1728563251,1728565092
12504,129000,85201,43799,1728563531,1728565938
12506,66257,62669,3588,1728563586,1728565753
12508,192908,185470,7438,1728565995,1728565742
12510,371512,364696,6816,1728565885,1728565745
12512,98000,86369,11631,1728565345,1728565739
12514,30723,27050,3673,1728565416,1728561705
12516,8931,15000,-6069,1728552579,1728564762
12518,5142,6905,-1763,1728541318,1728562937
12520,7500,5500,2000,1728527414,1728561900
12522,5619,5619,0,1728553017,1728560761
12524,159994,120324,39670,1728565190,1728565816
12526,445000,404503,40497,1728565102,1728565814
12528,16702,11000,5702,1728559458,1728564210
12530,5757,4200,1557,1728551703,1728564234
12532,5096,5000,96,1728563952,1728550902
12534,24669,9999,14670,1728549477,1728559552
12536,9999,5685,4314,1728534809,1728559807
12538,23193,18926,4267,1728534127,1728565788
12540,45000,40000,5000,1728554184,1728565296
12596,3868725,3835156,33569,1728565918,1728565993
12598,2087518,2074443,13075,1728559758,1728564873
12601,3240000,3171404,68596,1728565542,1728564545
12603,252001,239840,12161,1728564356,1728563462
12605,155000,159503,-4503,1728562608,1728565628
12613,1660,2000,-340,1728564421,1728565776
12614,4999,2642,2357,1728562598,1728565835
12615,2500,2500,0,1728565348,1728565708
12616,1044,1003,41,1728563498,1728565903
12617,7999,4994,3005,1728563741,1728565405
12618,4207,2700,1507,1728563897,1728565166
12619,7000,2500,4500,1728563728,1728565615
12620,5999,3157,2842,1728563702,1728565983
12621,24877,2500,22377,1728565632,1728565888
12622,7704,2385,5319,1728565668,1728565154
12623,2230,2058,172,1728565682,1728564485
12624,12000,2054,9946,1728565726,1728564955
12625,9725,9667,58,1728565996,1728565901
12627,7191,7153,38,1728565478,1728565762
12629,4631,4631,0,1728565873,1728564883
12631,2470,2215,255,1728565934,1728565724
12633,7000,7500,-500,1728564795,1728559905
12635,8995,2843,6152,1728542421,1728530078
12640,1400,1385,15,1728565872,1728565822
12642,6600,6351,249,1728565242,1728565207
12695,15384,15300,84,1728565980,1728565933
12697,12135,11913,222,1728565421,1728565925
12699,7485,7461,24,1728565904,1728565943
12701,3852,3760,92,1728564352,1728565465
12757,236181,236181,0,1728413986,1728553288
12759,164158,105555,58603,1728559620,1728564533
12761,58186,35003,23183,1728551520,1728564555
12763,694134,610000,84134,1728558838,1728564530
12769,807585,733000,74585,1728564201,1728553280
12771,802000,801000,1000,1728564557,1728557729
12775,1946,1934,12,1728565991,1728565843
12776,1222,1221,1,1728565145,1728565418
12777,824,808,16,1728565919,1728565088
12778,1799,1659,140,1728565328,1728565934
12779,1264,1250,14,1728565329,1728565071
12780,1691,1318,373,1728565567,1728565805
12781,1406,860,546,1728565658,1728565826
12782,1301,1202,99,1728565996,1728565836
12783,5780,5600,180,1728565778,1728565474
12786,56256,55510,746,1728565977,1728565598
12789,179999,169922,10077,1728564493,1728565564
12798,420000,317666,102334,1728558218,1728564537
12800,481642,408000,73642,1728565447,1728561582
12802,900000,512117,387883,1728549691,1728564539
12804,4185668,4076015,109653,1728561079,1728562031
12817,704999995,699790095,5209900,1728565139,1728561804
12819,689885000,693323000,-3438000,1728180178,1728549417
12821,45541289,44806888,734401,1728565010,1728565103
12823,44617065,44143295,473770,1728422793,1728563846
12825,131164817,128919783,2245034,1728558477,1728565792
12827,130780000,128461064,2318936,1728562558,1728564647
12829,96425,96053,372,1728565887,1728565708
12831,732245,724158,8087,1728565788,1728565482
12833,874999,626967,248032,1728565120,1728563850
12846,8589444,8200000,389444,1728547728,1728560542
12849,799999,772083,27916,1728558574,1728557948
12851,33900,33700,200,1728565916,1728564514
12863,763398,755601,7797,1728565967,1728565992
12865,7884,7884,0,1728565617,1728562177
12867,10852,10852,0,1728564029,1728564381
12869,12500,12120,380,1728565869,1728516225
12871,14774,14590,184,1728565963,1728557015
12873,1168416,1130009,38407,1728565866,1728565782
12875,646257,644297,1960,1728565776,1728564702
12877,4700000,4631122,68878,1728565919,1728565732
12879,779089,753299,25790,1728564456,1728564652
12881,7749999,7500000,249999,1728565869,1728565070
12883,2608000,2599999,8001,1728565390,1728561453
12885,882019,750000,132019,1728564973,1728538879
12900,5938252,5866671,71581,1728565706,1728565518
12902,15375483,15226000,149483,1728565885,1728565865
12905,10420,10393,27,1728565904,1728565946
12907,8079,7303,776,1728555396,1728565865
12909,5800,4800,1000,1728565759,1728565581
12911,2900,2400,500,1728565293,1728565607
12913,13320,13320,0,1728565994,1728565932
12915,10250,9580,670,1728565636,1728565386
12917,6191,6210,-19,1728550200,1728565945
12919,3133,2911,222,1728565801,1728565982
12922,6110000,6021000,89000,1728565724,1728565956
12924,6200000,6119404,80596,1728565724,1728565979
12927,5855000,5760000,95000,1728561598,1728564954
12929,5807063,5734147,72916,1728565922,1728565780
12932,5732118,5672997,59121,1728565746,1728563333
12934,292,289,3,1728565991,1728565993
12936,51690,10000,41690,1728533823,1728558412
12938,12703,12457,246,1728565808,1728565587
12960,500,329,171,1728564233,1728552707
12962,718,686,32,1728563044,1728511926
12964,50098,67300,-17202,1728496213,1728451264
12966,49999,27500,22499,1728534366,1728403926
12968,213290,170231,43059,1728557695,1728545230
12970,171840,171840,0,1728426497,1728539556
12972,622,2000,-1378,1728558243,1728561587
12974,524,10,514,1728565162,1728499084
12976,168730,160696,8034,1728558421,1728541897
12978,153367,300000,-146633,1728496526,1728512172
12980,632824,620000,12824,1728563346,1728561341
12982,651563,623651,27912,1728558710,1728519436
12984,1899,1662,237,1728565624,1728559084
12986,2300,2610,-310,1728550620,1728353042
12988,6117,6045,72,1728565662,1728564940
12990,20000,11895,8105,1728554443,1728519531
12992,88589,62000,26589,1728520233,1728548731
12994,92000,50000,42000,1728524643,1728243521
12996,425333,400002,25331,1728564963,1728558643
12998,345000,340000,5000,1728557396,1728557475
13000,6453,6453,0,1728565212,1728561770
13002,11021,8763,2258,1728560273,1728444269
13004,30037,31617,-1580,1728564209,1728507350
13006,31286,38121,-6835,1728291639,1728541796
13008,33313,50000,-16687,1728562957,1728552827
13010,34568,33830,738,1728501281,1728525401
13012,18738,17776,962,1728562629,1728563577
13014,21616,11000,10616,1728565305,1728528822
13016,29831,29765,66,1728561522,1728546213
13018,70000,56759,13241,1728385844,1728330123
13020,50968,50474,494,1728562376,1728558727
13022,59824,65955,-6131,1728425079,1728453361
13024,131493,128000,3493,1728565504,1728564627
13026,131058,127801,3257,1728564191,1728562627
13028,159000,159000,0,1728563445,1728564581
13030,154922,121009,33913,1728532956,1728528992
13032,390794,390794,0,1728559677,1728565422
13034,370155,386396,-16241,1728564115,1728441284
13036,29126998,28651502,475496,1728564040,1728544043
13038,23800900,22287800,1513100,1728547644,1728450948
13040,314272,300000,14272,1728565411,1728558775
13042,309000,240015,68985,1728535552,1728521861
13044,864000,824000,40000,1728562646,1728558773
13046,900000,950773,-50773,1728558637,1728561649
13048,165000,155016,9984,1728564136,1728565792
13050,176727,154767,21960,1728550145,1728527959
13052,154153,137000,17153,1728565189,1728564748
13054,160242,137787,22455,1728475320,1728449710
13056,275000,247283,27717,1728563638,1728565743
13058,294995,280001,14994,1728544347,1728565981
13060,187000,182000,5000,1728560764,1728565544
13062,207036,217387,-10351,1728555520,1728565644
13064,773,265,508,1728495330,1728550165
13066,12300,11858,442,1728561391,1728556752
13149,25000,25000,0,1728563845,1728561217
13151,45113,41017,4096,1728565516,1728552447
13153,21000,22251,-1251,1728565447,1728558153
13155,16347,16177,170,1728565500,1728523862
13157,29500,31040,-1540,1728565474,1728564739
13159,24117,29211,-5094,1728565486,1728493998
13161,1062999,876000,186999,1728555886,1728539370
13163,748000,720000,28000,1728561757,1728561861
13165,602000,480000,122000,1728565530,1728565403
13167,685000,620000,65000,1728557366,1728539343
13169,778800,770000,8800,1728564009,1728560615
13171,775160,736406,38754,1728565203,1728561563
13173,71592,75359,-3767,1728565216,1728565130
13175,32000,31697,303,1728565437,1728564253
13190,13330649,13997181,-666532,1728565996,1728565991
13227,4277993,4148600,129393,1728565190,1728565161
13229,190000,186000,4000,1728563178,1728565948
13231,25700000,25650007,49993,1728565631,1728565245
13233,2390000,2202356,187644,1728563260,1728565247
13235,3491787,3434000,57787,1728565880,1728565776
13237,32268554,31833344,435210,1728565894,1728565560
13239,26216598,25884011,332587,1728565903,1728565981
13245,215000,140000,75000,1728549693,1728558651
13256,130000,102015,27985,1728564784,1728562242
13263,37159140,37012345,146795,1728565943,1728565948
13265,2450000,2417065,32935,1728564933,1728565990
13267,2469155,2300000,169155,1728561037,1728535950
13269,2585000,2325001,259999,1728552239,1728563903
13271,2412140,2375000,37140,1728565943,1728565957
13277,102668,90000,12668,1728562631,1728565302
13383,1931,1893,38,1728565531,1728565697
13385,5441,5727,-286,1728565806,1728564739
13387,10657,10079,578,1728565464,1728565260
13389,7491,6000,1491,1728565651,1728564743
13391,11,14,-3,1728565861,1728565966
13421,7,7,0,1728565896,1728565897
13431,99,97,2,1728565867,1728564827
13439,1357,1342,15,1728565315,1728565993
13441,1712,1685,27,1728565984,1728565665
13448,310,310,0,1728546474,1728564643
13451,558,555,3,1728520633,1728535001
13454,1397,1370,27,1728529022,1728563554
13457,641,639,2,1728521337,1728554213
13460,1900,1409,491,1728541219,1728564816
13463,749,788,-39,1728565910,1728565207
13466,1089,1090,-1,1728558898,1728545499
13469,1604,2100,-496,1728542907,1728564917
13472,900,832,68,1728565490,1728564845
13475,1116,1116,0,1728565986,1728565987
13478,1324,1250,74,1728559469,1728565406
13481,2210,1400,810,1728510367,1728565828
13484,2125,2077,48,1728546544,1728565628
13487,2313,1921,392,1728547441,1728563307
13490,2022,1945,77,1728551001,1728564507
13493,2349,2439,-90,1728564270,1728565992
13496,2988,2988,0,1728565958,1728565965
13499,2972,2803,169,1728565008,1728564629
13502,3954,3798,156,1728565322,1728565953
13505,5073,4800,273,1728537659,1728554488
13508,6500,6000,500,1728563263,1728565888
13511,8727,8717,10,1728564134,1728565940
13573,586,583,3,1728565394,1728565828
13576,22268000,22206441,61559,1728565862,1728565983
13652,81469000,80510999,958001,1728565985,1728565960
13657,661,809,-148,1728561481,1728559600
13658,237,220,17,1728564850,1728565384
19478,781958,778189,3769,1728564615,1728564927
19481,1447133,1422784,24349,1728565693,1728565710
19484,836,824,12,1728565981,1728565815
19486,1303,872,431,1728562722,1728533410
19488,1367,888,479,1728558132,1728540148
19490,2033,2016,17,1728565954,1728562095
19493,21190000,20452627,737373,1728193604,1728496586
19496,19500000,20750000,-1250000,1727460490,1728549824
19501,19412905,19063131,349774,1726116517,1725684704
19529,18328999,18307777,21222,1728556890,1728564470
19532,21455000,19899555,1555445,1728495439,1728330161
19535,30000000,21002003,8997997,1728560621,1728560685
19538,21225000,19575000,1650000,1728198472,1728055518
19541,21398000,21400000,-2000,1728358877,1728417793
19544,21102726,20909216,193510,1728565850,1728565995
19547,21189834,20922450,267384,1728565741,1728565991
19550,21190000,20914002,275998,1728565050,1728565668
19553,21155000,20961858,193142,1728565717,1728565981
19570,42,55,-13,1728562708,1728507465
19572,5,3,2,1728559580,1728529554
19574,1500,72,1428,1728508682,1728537814
19576,300,193,107,1728550458,1728554952
19578,310,310,0,1728545980,1728563974
19580,603,575,28,1728565740,1728565963
19582,924,906,18,1728564910,1728565999
19584,1,2,-1,1728565299,1728561252
19586,24104,31070,-6966,1728552783,1728565866
19589,211349,230000,-18651,1728559339,1728565998
19592,30000,30000,0,1728564363,1728559730
19595,34563,25500,9063,1728434042,1728174810
19598,145607,200000,-54393,1725803416,1728335825
19601,31494,31260,234,1728563860,1728564865
19604,50000,45000,5000,1728562791,1728506137
19607,320000,250000,70000,1728561130,1728549559
19610,1060372,1100000,-39628,1728563313,1728565644
19613,1699,1597,102,1728565584,1728565188
19615,1727,1573,154,1728565906,1728565192
19617,1850,1744,106,1728565884,1728565901
19619,1976,1800,176,1728565742,1728565465
19621,1893,1667,226,1728565951,1728564707
19623,2670,2530,140,1728565322,1728564239
19625,2227,2021,206,1728565246,1728563606
19627,2763,2763,0,1728566001,1728562608
19629,2825,2716,109,1728565680,1728565540
19631,2729,2403,326,1728565456,1728563715
19653,1256,1275,-19,1728565077,1728562637
19656,2467,2590,-123,1728539308,1728565683
19662,2599,2059,540,1728565959,1728564924
19665,113,113,0,1728547708,1728538511
19669,535,533,2,1728565877,1728565681
19672,4599,4501,98,1728565977,1728565322
19701,740000,521000,219000,1728544467,1728544480
19707,53163112,52196273,966839,1728564122,1728564298
19724,14500,14103,397,1728555221,1728559105
19727,24568,24568,0,1728544648,1728562239
19912,19000,10000,9000,1728537132,1728560217
19915,6230,5225,1005,1728556208,1728557715
19918,4616,6630,-2014,1728562554,1728555233
19921,820042,780338,39704,1728565787,1728565952
19924,477453,457229,20224,1728565939,1728565956
19927,443926,426837,17089,1728565562,1728565389
19930,878486,843864,34622,1728565006,1728565948
19933,479116,458893,20223,1728565772,1728565931
19936,760866,725860,35006,1728565666,1728565489
19943,6815,6006,809,1728528622,1728563872
19946,22222,6000,16222,1728552604,1728553926
19949,5449,5449,0,1728564907,1728541493
19952,33333,5888,27445,1728553471,1728554453
19955,5382,3787,1595,1728562593,1728553198
19958,3348616,2522020,826596,1728546533,1728554139
19961,981996,711009,270987,1728528535,1728554133
19964,1950000,1600000,350000,1728524724,1728558600
19967,795000,567842,227158,1728495400,1728554172
19970,834152,1067277,-233125,1728509890,1728532998
19973,2518139,2400000,118139,1728547461,1728546588
19976,965000,561134,403866,1728467876,1728564683
19979,580000,450000,130000,1728536934,1728528721
19982,5000000,1400000,3600000,1728402063,1728546290
19985,1200000,607000,593000,1728240997,1728515908
19988,74949,60522,14427,1728553135,1728546805
19991,100000,100000,0,1728565902,1728562222
19994,800000,719888,80112,1728562461,1728563944
19997,1635322,1415000,220322,1728553431,1728561573
20002,364000,333335,30665,1728565288,1728563921
20005,8999888,8666000,333888,1728556832,1728563199
20008,20915,20001,914,1728529189,1728559688
20011,2147483647,2147483647,0,1710961729,1712988916
20014,2147483647,2147483647,0,1705761381,1697321028
20017,15650000,15350000,300000,1728556727,1728548827
20020,9315,9001,314,1728560525,1728564600
20023,16418,11450,4968,1728560441,1728561233
20026,100000,76000,24000,1728565462,1728564743
20029,28880,20005,8875,1728565602,1728561265
20032,98888,48407,50481,1728560496,1728560396
20035,106000,77500,28500,1728539099,1728565343
20038,75611,69068,6543,1728542756,1728560832
20041,105000,75000,30000,1728555859,1728562370
20044,76999,60000,16999,1728542744,1728556528
20047,23843,17500,6343,1728542607,1728565043
20050,894307,856000,38307,1728565572,1728564885
20053,50000,36804,13196,1728544967,1728564609
20056,337746,311999,25747,1728561658,1728565909
20059,5200000,5000000,200000,1728541290,1728562683
20062,642587,600005,42582,1728564657,1728565314
20065,3649676,3582130,67546,1728564742,1728565432
20068,149995,111712,38283,1728549499,1728564229
20071,4138995,3960000,178995,1728556148,1728565303
20074,2194999,2070000,124999,1728565625,1728565312
20077,168776,105001,63775,1728556783,1728565819
20080,9999888,4222000,5777888,1728440338,1728501480
20083,7876000,7300000,576000,1728504758,1728516848
20086,799999,600000,199999,1728560656,1728546446
20089,2499998,1830003,669995,1728484119,1728507539
20092,999000,800010,198990,1728543630,1728515922
20095,11100000,10850000,250000,1728556739,1728545962
20098,25200888,24701696,499192,1728563918,1728564292
20101,3550000,3351000,199000,1728546239,1728565250
20104,8108889,7715000,393889,1728552264,1728559395
20107,3674998,3566666,108332,1728563893,1728564295
20110,23598,21000,2598,1728545418,1728558866
20113,3602,3774,-172,1728564705,1728565126
20116,2953,2845,108,1728563487,1728563900
20119,2955,3218,-263,1728528271,1728562444
20122,5078,5101,-23,1728519741,1728561841
20125,15000,4702,10298,1728565392,1728563245
20128,46135,36042,10093,1728564714,1728562441
20131,85000,71002,13998,1728564689,1728564651
20134,39999,16000,23999,1728544540,1728565051
20137,67529,46000,21529,1728564782,1728565018
20140,19545,19000,545,1728545499,1728565218
20143,73094,125776,-52682,1728565840,1728562848
20146,1600000,1500000,100000,1728554362,1728554368
20149,2452000,2374087,77913,1728564122,1728559118
20152,1675000,1575001,99999,1728556251,1728556293
20155,5945000,5699232,245768,1728565466,1728555651
20158,4000000,3500000,500000,1728403715,1728509252
20161,950000,905059,44941,1728559036,1728563496
20166,215253,175750,39503,1728536339,1728561054
20169,12802,8622,4180,1728553799,1728548434
20172,2943,2875,68,1728520997,1728547539
20175,2309,6000,-3691,1728513280,1728563822
20178,2500,2500,0,1728548409,1728564835
20181,8458,7905,553,1728565327,1728565335
20184,10594,9153,1441,1728549044,1728552651
20187,2982,2691,291,1728542239,1728556846
20190,4553,4335,218,1728100992,1728547545
20193,10622,8325,2297,1728563084,1728561351
20196,80000,10000,70000,1728454361,1728562008
20199,4912279,4837005,75274,1728541167,1728554823
20202,2266460,1975000,291460,1728544162,1728508527
20205,519680,475000,44680,1728565563,1728542039
20208,313681,313681,0,1728565555,1728565538
20211,3888880,3738394,150486,1728557751,1728555686
20214,1595117,1565000,30117,1728559224,1728547560
20217,1404733,1377688,27045,1728564537,1728562052
20220,5589,8187,-2598,1728565849,1728565752
20223,26961,32770,-5809,1728565638,1728565737
20226,10248,6002,4246,1728565901,1728564997
20229,6431,6000,431,1728565412,1728565540
20232,10899,9000,1899,1728565932,1728565621
20235,5639,5641,-2,1728565790,1728565615
20238,205,200,5,1728565894,1728565631
20240,5000,4044,956,1728537052,1728563744
20243,3596,4000,-404,1728503972,1728565913
20246,5006,3750,1256,1728564259,1728562763
20251,1963,1555,408,1728535386,1728562759
20254,6500,2500,4000,1728552466,1728524482
20257,1659,2976,-1317,1728505272,1728564020
20260,11851,11657,194,1728552024,1728560881
20263,1799,1555,244,1728533466,1728556603
20266,29915,19930,9985,1728560376,1728562744
20269,23825,11355,12470,1728560570,1728556045
20272,10584,9000,1584,1728556153,1728565135
20275,11000,4500,6500,1728541305,1728565658
20376,60026,52326,7700,1728471170,1728519752
20379,134999,122435,12564,1728505657,1728181036
20382,30463,48328,-17865,1728524832,1728343358
20385,59000,49009,9991,1728538264,1728252370
20433,348582,663910,-315328,1728553767,1728558474
20436,287347,250000,37347,1728565935,1728565766
20439,345838,275000,70838,1728565877,1728551841
20442,373483,363636,9847,1728565884,1728558478
20517,441432,426368,15064,1728565770,1728564627
20520,274491,251909,22582,1728565762,1728564657
20590,1199998,931466,268532,1728565761,1728549767
20595,276576,265377,11199,1728565753,1728565587
20716,646251,638420,7831,1728565819,1728565978
20718,1775,1758,17,1728565894,1728565899
20724,106234006,104600001,1634005,1728563458,1728563947
20727,65998,60446,5552,1728565440,1728565806
20730,54090,45416,8674,1728563826,1728564867
20733,73511,68125,5386,1728563290,1728560183
20736,18495,15300,3195,1728565163,1728565951
20739,44842,30618,14224,1728563248,1728564672
20749,1343,1301,42,1728545026,1728557294
20756,1170999,1134119,36880,1728564632,1728565653
20849,359,354,5,1728565723,1728565469
20997,1688000000,1685111111,2888889,1728565929,1728564663
21000,18348089,18176084,172005,1728565987,1728565472
21003,131384444,130200080,1184364,1728564893,1728565926
21006,119763222,118381115,1382107,1728565826,1728564825
21009,129933,127612,2321,1728565991,1728565270
21012,58992364,58165117,827247,1728565998,1728565759
21015,20916467,20710451,206016,1728565920,1728565467
21018,48418264,47843501,574763,1728565821,1728565770
21021,155000000,153500000,1500000,1728565965,1728564993
21024,116400000,115000000,1400000,1728565812,1728565595
21028,2010000,1952022,57978,1728565651,1728565203
21034,15898999,15791012,107987,1728565948,1728565940
21043,118821490,116300000,2521490,1728516268,1728564055
21047,49588,47353,2235,1728565814,1728565996
21049,319800000,317000000,2800000,1728565048,1728565142
21079,1950155,1901250,48905,1728565790,1728565118
21081,1450,1000,450,1728526202,1728500233
21084,717,721,-4,1728530268,1728565698
21087,3300,3300,0,1728557556,1728544576
21090,1190,1060,130,1728565703,1728550125
21093,754,550,204,1728562472,1728533075
21096,506,505,1,1728415018,1728439071
21099,485,485,0,1728535448,1728553312
21102,866,750,116,1728564862,1728545245
21105,3012,2704,308,1728565540,1728557964
21108,639,639,0,1728440666,1728493982
21111,744,601,143,1728565119,1728539692
21114,3223,3068,155,1728565271,1728556571
21117,1165,1056,109,1728558399,1728557371
21120,747,1000,-253,1728418307,1728528506
21123,2881,2800,81,1728565083,1728545195
21126,1794,1528,266,1728565146,1728560549
21129,572,1067,-495,1728565979,1728551794
21140,2080,1513,567,1728565440,1728557610
21143,1842,1827,15,1728565929,1728565294
21146,1067,1007,60,1728565984,1728565455
21157,513,450,63,1728555218,1728501123
21160,767,500,267,1728555015,1728551382
21163,1144,1140,4,1728565793,1728565670
21166,3800,3706,94,1728565978,1728565372
21177,1488,1400,88,1728565544,1728564988
21180,1114,1000,114,1728565969,1728564924
21183,3548,3508,40,1728565712,1728565707
21202,370000,317000,53000,1728531709,1728564543
21257,1672,1672,0,1728565223,1728565224
21270,8652632,8436589,216043,1728562943,1728565123
21279,2423516,2262552,160964,1728564063,1728563214
21298,607885,585000,22885,1728565439,1728563759
21301,964259,947277,16982,1728565427,1728565865
21304,736993,711662,25331,1728565677,1728565973
21316,202,190,12,1728565695,1728565222
21318,412,308,104,1728560898,1728561447
21320,749,1,748,1728496002,1728202836
21322,10,10,0,1728533615,1728500873
21324,1000,15,985,1728446752,1728248267
21326,164,160,4,1728565953,1728565942
21332,384,305,79,1728563581,1728562786
21334,551,351,200,1728563080,1728545522
21336,1306,1268,38,1728565361,1728565745
21338,177,159,18,1728565854,1728564336
21347,3282,3250,32,1728565543,1728565819
21350,223,222,1,1728565827,1728565464
21352,699,661,38,1728566001,1728561747
21387,299997,275113,24884,1728565840,1728565646
21477,345,315,30,1728565896,1728565884
21480,1922,1661,261,1728565985,1728564484
21483,319,319,0,1728565849,1728565758
21486,61,60,1,1728565797,1728565597
21488,1266,1183,83,1728565314,1728565825
21490,210,179,31,1728563203,1728565958
21504,190,185,5,1728564595,1728565817
21512,1344,851,493,1728558643,1728556729
21515,877,1182,-305,1728564096,1728541825
21518,936,600,336,1728565096,1728546302
21521,1700,976,724,1728565800,1728561402
21543,37,37,0,1728564145,1728565032
21545,48,48,0,1728565026,1728565857
21555,38,37,1,1728565877,1728565862
21622,60,59,1,1728565026,1728565847
21626,4000,2051,1949,1728537573,1728559507
21634,22950000,22211000,739000,1728565799,1728552127
21637,23550000,22585000,965000,1728553959,1728554071
21643,369399,357796,11603,1728565167,1728565773
21646,19908,18701,1207,1728565517,1728564364
21649,1243289,1186954,56335,1728559672,1728539170
21652,3101,2863,238,1728564353,1728563949
21684,5715,4902,813,1728533571,1728533577
21690,2534,2425,109,1728565793,1728564674
21730,7333000,7220000,113000,1728541221,1728561493
21733,7998000,7779995,218005,1728564662,1728565135
21736,84347,71503,12844,1728563333,1728565973
21739,34562,31777,2785,1728564165,1728564403
21742,383000,365764,17236,1728565772,1728565689
21745,3732186,3225020,507166,1728513304,1728529508
21754,231,255,-24,1728558489,1728564205
21802,346,341,5,1728565883,1728565537
21804,152481,149209,3272,1728565753,1728565711
21807,500000,499008,992,1728548195,1728565970
21810,1000000,997449,2551,1728526200,1728565718
21813,1896388,1905000,-8612,1728565043,1728565673
21817,43951,44100,-149,1728565671,1728566001
21820,179,177,2,1728565995,1728565998
21838,42420,25001,17419,1728560560,1728561252
21880,306,303,3,1728565945,1728565975
21882,147800000,143333000,4467000,1728533967,1728392327
21885,104281888,132592936,-28311048,1694374336,1728008064
21892,2500000,2437409,62591,1728565605,1728558028
21895,71439676,71002003,437673,1728564621,1728559004
21902,1331051,1314985,16066,1728565956,1728565945
21905,893,885,8,1728565199,1728565953
21918,1362655,1310111,52544,1728565810,1728565958
21921,1294959,1294959,0,1728565882,1728565884
21924,1259,740,519,1728496717,1728534668
21926,700,611,89,1728554731,1728533273
21928,1737,1702,35,1728562319,1728563369
21930,912,900,12,1728564990,1728565878
21932,999,975,24,1728565853,1728565795
21934,944,553,391,1728534458,1728553766
21936,1060,560,500,1728547534,1728553617
21938,537,420,117,1728558223,1728543032
21940,927,898,29,1728565886,1728565515
21942,703,815,-112,1728429068,1728563120
21944,1068,1061,7,1728565963,1728565934
21946,1124,1104,20,1728565905,1728565930
21948,999,976,23,1728565384,1728565817
21950,9294,9225,69,1728565018,1728562460
21952,179,179,0,1728565819,1728557052
21955,1213,976,237,1728506062,1728556304
21957,924,1177,-253,1728553704,1728425381
21959,394,784,-390,1728554833,1728121524
21961,1021,1021,0,1728436346,1728436406
21963,904,851,53,1728564784,1728556915
21965,847,847,0,1728542378,1728540771
21967,1010,1007,3,1728565425,1728565532
21969,1085,1055,30,1728560194,1728564624
21971,1692,1692,0,1728565107,1728561616
21973,9708,9260,448,1728554791,1728554799
21975,26414,26000,414,1728565893,1728565898
21978,25507,25022,485,1728565735,1728565502
21981,11742,15000,-3258,1727838365,1728560228
21984,8400,8401,-1,1725807455,1728560775
21987,4000,4501,-501,1728276981,1728565771
21994,80000,3532,76468,1728303624,1727801211
21997,1,3329,-3328,1698800643,1728303648
22003,11173437,11040250,133187,1728565245,1728565853
22006,11000000,10735000,265000,1728565426,1728564782
22097,1933808,1500000,433808,1728414822,1728439550
22100,65999000,69169169,-3170169,1728027194,1728432780
22103,383882,381000,2882,1728548011,1728565027
22106,60000,30100,29900,1728561267,1728565308
22111,75333,75180,153,1728565876,1728565926
22118,660,630,30,1728527868,1728565861
22121,498,100,398,1728548391,1728541927
22124,26294,25984,310,1728565960,1728565966
22192,1370,931,439,1728564592,1728564030
22195,1900,1892,8,1728564380,1728561104
22198,1599,1446,153,1728565988,1728564471
22201,2499,2475,24,1728565974,1728565531
22204,1729,1666,63,1728565862,1728563140
22209,23424,23365,59,1728566000,1728565869
22212,20700,17694,3006,1728559601,1728564636
22215,9400,9410,-10,1728524260,1728564633
22218,7499,4800,2699,1728564639,1728565224
22221,14444,6812,7632,1728542179,1728444270
22224,32300,3169,29131,1719925430,1727932780
22231,40241,35884,4357,1728561211,1728565491
22236,10618654,10101000,517654,1728565221,1728551900
22239,5468633,4500044,968589,1728534205,1728538050
22246,5755884,5700000,55884,1728563002,1728565379
22251,78,2,76,1728565417,1728564879
22254,16,10,6,1728551143,1728565999
22257,41,38,3,1728565328,1728564084
22260,131,162,-31,1728525991,1728565623
22263,469,350,119,1728561562,1728560476
22266,382,421,-39,1728558362,1728565242
22269,2500,500,2000,1728565395,1728547047
22272,310,306,4,1728562866,1728565985
22275,2930,2690,240,1728563721,1728563753
22278,4067,6000,-1933,1728563805,1728565416
22281,7988,6308,1680,1728565251,1728565580
22284,21586,21102,484,1728565838,1728565963
22290,6646454,6365269,281185,1728536764,1728539230
22294,12157264,11730816,426448,1728565662,1728565697
22296,10196997,10024100,172897,1728564570,1728565129
22299,3993053,3992001,1052,1728511899,1728562909
22302,8500000,7985001,514999,1728539972,1728565903
22305,15984000,15976000,8000,1728510086,1728565370
22324,53692101,53104876,587225,1728565582,1728565566
22326,13491914,13316888,175026,1728563174,1728565972
22327,15064817,15000000,64817,1728564411,1728565974
22328,12525000,12500000,25000,1728565264,1728565977
22368,11832810,11656556,176254,1728565029,1728564120
22372,11563632,11585654,-22022,1728527369,1728565544
22430,905,892,13,1728453610,1728422390
22438,40750000,40323395,426605,1728565935,1728564540
22443,23228,21700,1528,1728559914,1728547252
22446,18591,18315,276,1728565972,1728565962
22449,29996,27635,2361,1728565627,1728562323
22452,14914,16441,-1527,1728474532,1728565456
22455,11403,11403,0,1728491522,1728530030
22458,4450,5000,-550,1728497027,1728562636
22461,29190,29001,189,1728565946,1728565460
22464,22050,21666,384,1728541552,1728564967
22467,12780,12977,-197,1728300510,1728565795
22470,6619,6601,18,1728565742,1728564090
22477,60099888,59800000,299888,1728565734,1728565851
22481,70111774,69250002,861772,1728565550,1728565603
22486,1671999998,1668191123,3808875,1728563194,1728564564
22542,7143049,7051475,91574,1728564604,1728565995
22547,22468000,22114000,354000,1728565997,1728564666
22552,2519000,2495512,23488,1728565796,1728565985
22557,385773,385190,583,1728565992,1728565934
22593,83,81,2,1728565879,1728558213
22595,89,87,2,1728565846,1728553083
22597,80,84,-4,1728565862,1728558195
22599,950,911,39,1728565968,1728563928
22601,1061,1061,0,1728565414,1728565413
22603,629,599,30,1728565791,1728563505
22731,59998,41876,18122,1728565993,1728562782
22734,53000,27750,25250,1728432090,1728508695
22737,52638,36000,16638,1728491739,1728560911
22740,76837,43333,33504,1728557527,1728553915
22780,2228,2228,0,1728565750,1728565741
22783,5198,5198,0,1728565072,1728565977
22786,11700,10560,1140,1728563368,1728565995
22789,2100,1900,200,1728557041,1728529703
22795,716,576,140,1728565645,1728565310
22804,5692,5678,14,1728565694,1728565980
22806,6326,6540,-214,1728565689,1728551920
22808,6523,5918,605,1728565682,1728562915
22810,6991,6727,264,1728565724,1728565122
22818,17,9,8,1728564659,1728559742
22826,19,11,8,1728560307,1728548253
22829,670,666,4,1728547251,1728548268
22832,10,10,0,1728469410,1728548280
22835,127,77,50,1728495466,1728529393
22856,70920,70089,831,1728565973,1728562295
22859,24265,24265,0,1728565881,1728565868
22866,191935,187897,4038,1728565883,1728565796
22869,67888,67205,683,1728556266,1728565945
22871,23019,22835,184,1728565956,1728565940
22873,75,69,6,1728558815,1728565475
22877,184999,184556,443,1728562687,1728565995
22879,9222,9061,161,1728565781,1728565969
22887,3885,3681,204,1728565687,1728562692
22929,1415,1279,136,1728565928,1728565507
22932,755,701,54,1728532205,1728564765
22935,8446,8340,106,1728547956,1728565984
22949,1980,1962,18,1728565655,1728564246
22951,435339,419000,16339,1728565747,1728565785
22954,2415999,2366909,49090,1728565645,1728565970
22957,430078,416111,13967,1728560069,1728565278
22960,80134,72000,8134,1728563387,1728562438
22963,41000,41000,0,1728510322,1728565806
22966,63000000,63721641,-721641,1728525189,1728564181
22975,3018509,2996205,22304,1728565524,1728565992
22978,67920915,68000000,-79085,1728565880,1728565933
22983,11140914,10951000,189914,1728565766,1728565627
22988,90970,70062,20908,1728562171,1728557764
22994,831481,808631,22850,1728565188,1728565164
22999,49000,16002,32998,1728549054,1728565696
23002,17723,16303,1420,1728565860,1728564873
23037,212,50,162,1728565535,1728563199
23047,36031,27865,8166,1728560182,1728565791
23050,106695,70005,36690,1728564378,1728561867
23053,89332,72004,17328,1728563257,1728560442
23056,32000,16000,16000,1728560662,1728562893
23059,43948,46565,-2617,1728563114,1728553118
23064,125000,158434,-33434,1728490084,1728562863
23110,165000,150903,14097,1728560906,1728557338
23113,159028,151969,7059,1728565941,1728565105
23116,324777,282202,42575,1728563977,1728559934
23119,300399,274600,25799,1728559754,1728538821
23124,23200000,23171076,28924,1728556810,1728449395
23185,4936674,4857208,79466,1728557103,1728557447
23188,211299,200615,10684,1728562835,1728559828
23191,496969,340000,156969,1728560341,1728565494
23194,231447,189010,42437,1728559871,1728559877
23197,299969,222222,77747,1728513865,1728564407
23200,306308,321623,-15315,1728565813,1728559609
23203,216343,183000,33343,1728529360,1728562993
23206,20000,11000,9000,1728522436,1728561665
23209,74999,75000,-1,1728264337,1728563031
23212,48500,46127,2373,1728558627,1728565068
23215,59000,53545,5455,1728522477,1728553649
23218,51329,50703,626,1728557696,1728554172
23221,58000,51601,6399,1728531006,1728539677
23224,12311,6222,6089,1728565820,1728544065
23227,15000,12619,2381,1728553798,1728565553
23232,5505,5675,-170,1728564186,1728562013
23237,20000,10003,9997,1728563642,1728561877
23242,119999999,116250000,3749999,1728541201,1728485249
23246,3647770,3566776,80994,1728565908,1728563874
23249,274997,246000,28997,1728562468,1728564344
23252,96237,105000,-8763,1728559095,1728564632
23255,49999,23543,26456,1728539416,1728559653
23258,703662,701127,2535,1728564658,1728541334
23261,6702000,6451000,251000,1728564387,1728553881
23264,4188888,4044000,144888,1728561252,1728555608
23267,12330992,12330992,0,1728564381,1728561236
23270,5951,5650,301,1728530161,1728562899
23273,25985,24951,1034,1728552144,1728563797
23276,5151511,4981000,170511,1728551058,1728547954
23279,6171711,5925000,246711,1728556933,1728565180
23282,4397134,4181134,216000,1728564554,1728561208
23285,896990,860000,36990,1728565605,1728559921
23288,120000,93027,26973,1728565536,1728563135
23291,99000,60518,38482,1728565812,1728563128
23294,77000,59262,17738,1728565408,1728558631
23297,42548,38183,4365,1728565593,1728565652
23300,264253,251333,12920,1728565748,1728565915
23303,46302,41165,5137,1728563322,1728562938
23306,20775,24268,-3493,1728559204,1728561052
23309,14444,9666,4778,1728554122,1728565663
23312,3978,2298,1680,1728565700,1728565806
23315,3361,3319,42,1728565707,1728565797
23318,2439,2001,438,1728565691,1728564349
23321,7777,5000,2777,1728562639,1728563420
23324,12714,11100,1614,1728564128,1728563112
23327,18430,16000,2430,1728565664,1728565546
23336,2147483647,2147483647,0,1713538969,1727295691
23339,2147483647,2147483647,0,1725068317,1727295704
23342,1523371421,1466804000,56567421,1728551431,1728495195
23345,1893123678,1866666666,26457012,1728551380,1728515262
23348,2043050,1986215,56835,1728561949,1728565733
23351,4832829,4766084,66745,1728565827,1728565222
23354,512271,482250,30021,1728555544,1728547185
23357,175989,156000,19989,1728553215,1728547087
23360,2495636,2417121,78515,1728565149,1728564447
23363,190000,187050,2950,1728531303,1728561638
23366,2540,3116,-576,1728506571,1728552602
23369,2404,2288,116,1728552497,1728565993
23372,2188,2188,0,1728521879,1728549171
23375,2247,2222,25,1728544709,1728546995
23378,3135,3121,14,1728472900,1728552412
23381,179881,150000,29881,1728558774,1728554432
23384,29000,12127,16873,1728560778,1728548775
23387,19000,18669,331,1728565574,1728562309
23389,1200000,1163523,36477,1728563500,1728565967
23392,9502,9494,8,1728564761,1728562812
23395,9475,9474,1,1728439986,1728564996
23398,9446,9456,-10,1728553500,1728565464
23401,9431,9441,-10,1728548088,1728565130
23404,9899,9483,416,1728500208,1728562789
23407,20000,18000,2000,1728562468,1728561628
23410,44000,30000,14000,1728565824,1728565500
23413,53000,47000,6000,1728565844,1728565190
23490,135808,134271,1537,1728565952,1728565688
23499,41134,39000,2134,1728564459,1728565853
23517,38024,37500,524,1728556757,1728565776
23522,17043,16501,542,1728560533,1728561236
23525,187050,180000,7050,1728564979,1728563709
23528,219000,201940,17060,1728565428,1728565928
23667,5349000,3800000,1549000,1728551651,1728482440
23685,21482,21221,261,1728566001,1728565867
23688,16726,15000,1726,1728565386,1728565087
23691,9241,8825,416,1728563969,1728565959
23694,5478,4823,655,1728565118,1728563820
23697,3099,3086,13,1728565924,1728561447
23700,1736,1736,0,1728506103,1728563160
23703,975,975,0,1728517063,1728548323
23706,568,560,8,1728264641,1728563845
23709,8400,8111,289,1728565936,1728561499
23712,5130,5386,-256,1728461713,1728557380
23715,50001,3400,46601,1728431135,1728564428
23718,3000,1700,1300,1728520847,1728563862
23721,7979,6116,1863,1728559967,1728565581
23724,2597,3750,-1153,1728417117,1728560983
23727,68001,1768,66233,1727444193,1728552325
23730,1030,1000,30,1727916823,1728515389
23733,5839,5751,88,1728565927,1728565946
23736,4756,4960,-204,1728565725,1728563422
23739,3482,2615,867,1728565712,1728564157
23742,1566,1304,262,1728564513,1728563363
23745,3070,2851,219,1728565918,1728565492
23748,3199,1904,1295,1728541496,1728563253
23751,1583,1158,425,1728072377,1728564505
23754,1530,1200,330,1728561375,1728564455
23908,179000,85000,94000,1728561584,1728565528
23943,3000000,2800000,200000,1728563881,1728553471
23948,50000,300,49700,1728223477,1728501398
23953,21701137,21362239,338898,1728564607,1728565294
23956,10199587,10199587,0,1728565967,1728565967
23959,2393381,2359328,34053,1728565838,1728565999
23997,157490000,154555556,2934444,1728562809,1728555960
24000,293816,258420,35396,1728553813,1728564534
24003,5246,5000,246,1728562134,1728539654
24006,11111,8750,2361,1728564075,1728528078
24009,4140,25000,-20860,1728538546,1728474570
24012,6500,1102,5398,1728458331,1728441328
24015,14123,2005,12118,1728565495,1728544914
24018,14998,9557,5441,1728565449,1728544059
24021,14995,6456,8539,1728549991,1728476308
24024,9373,2169,7204,1728537416,1728508815
24027,5091,2005,3086,1728539563,1728522315
24034,1257698,1168000,89698,1728564913,1728561569
24037,1253450,1200000,53450,1728563369,1728552854
24040,1205467,1125000,80467,1728528355,1728554629
24043,380000,316365,63635,1728560161,1728552838
24046,696420,575236,121184,1728558211,1728560684
24144,27000000,26080000,920000,1728523923,1728559215
24187,510088,502501,7587,1728565939,1728565939
24219,9332582,9132563,200019,1728559846,1728564555
24229,427719,423340,4379,1728565950,1728565840
24251,30699,30295,404,1728565942,1728565991
24268,23500000,23333523,166477,1728565820,1728565830
24288,369635,359100,10535,1728565228,1728563518
24291,1782605,1762600,20005,1728565209,1728565425
24294,697505,677600,19905,1728564066,1728565452
24333,3240000,3423311,-183311,1728565371,1728556743
24336,3130,2584,546,1728564832,1728565200
24387,532870,936824,-403954,1728541377,1728556739
24389,4888000,4427677,460323,1728537296,1728554952
24391,367302,160000,207302,1728497310,1728537341
24393,529696,444444,85252,1728532273,1728537285
24395,950000,750000,200000,1728542362,1728525698
24397,999997,169000,830997,1728505525,1728356087
24399,899998,625000,274998,1728511616,1728511753
24401,69597,1200,68397,1728525666,1728327042
24403,111110,111110,0,1728532655,1728558191
24405,194688,81886,112802,1728529065,1728548698
24407,767804,420000,347804,1728550030,1728555002
24409,99997,57444,42553,1728509482,1728555010
24411,49697,52186,-2489,1728519689,1728543155
24413,425000,400000,25000,1728555356,1728555474
24417,378088680,373850123,4238557,1728564440,1728565055
24419,46280687,45705433,575254,1728564229,1728563571
24420,76089201,75750000,339201,1728564451,1728564202
24421,151899986,149626123,2273863,1728562750,1728565477
24422,55313013,54600928,712085,1728564372,1728565957
24460,588951,460000,128951,1728560963,1728519708
24463,3498444,3040746,457698,1728565196,1728558820
24466,2690000,2600000,90000,1728558958,1728565908
24469,1281037,1243374,37663,1728485904,1728294229
24472,1559050,826000,733050,1728542344,1728441679
24475,6850000,6549669,300331,1728522924,1728504516
24488,273179904,269458719,3721185,1728564030,1728565808
24495,1499998,1126000,373998,1728542913,1728549912
24511,352023572,347808892,4214680,1728565008,1728558668
24514,117330451,116370761,959690,1728560025,1728565960
24517,293995000,292191955,1803045,1728562447,1728561711
24585,22144,10000,12144,1728565998,1728565382
24587,2200000,2110222,89778,1728565622,1728561842
24589,495,490,5,1728565992,1728565866
24592,390,385,5,1728565859,1728565926
24595,199,191,8,1728565988,1728565752
24598,5381,5317,64,1728565935,1728565940
24607,613,612,1,1728565993,1728565999
24609,30,21,9,1695205762,1695205416
24611,99,77,22,1695205723,1695205711
24613,70,69,1,1728565855,1728565916
24615,63,61,2,1728565861,1728565928
24621,77,77,0,1728565935,1728565935
24623,30993,28241,2752,1728565544,1728563618
24626,29993,19005,10988,1727909501,1728555345
24629,7119,11002,-3883,1726833868,1728539391
24632,21844,6500,15344,1728518836,1728549154
24635,34467,33936,531,1728565963,1728565760
24638,24300,24301,-1,1728241739,1728564635
24641,16000,16002,-2,1728241795,1728561220
24644,15000,9014,5986,1728565118,1728562436
24740,63100,61060,2040,1728565916,1728563533
24774,88,92,-4,1728553413,1728564447
24777,10419819,10288999,130820,1728565363,1728565994
24782,462,1000,-538,1728371162,1728559788
24785,272,177,95,1728536182,1728559275
24844,22089999,21950023,139976,1728565700,1728563989
24949,798,753,45,1728564294,1728560455
24951,1050,939,111,1728565738,1728554337
24953,1017,1000,17,1728565942,1728563363
24955,1566,1171,395,1728559809,1728564605
24957,1420,1112,308,1728565917,1728563556
24959,1111,615,496,1728560053,1728541145
24961,1400,1399,1,1728565988,1728564940
24963,1507,1398,109,1728566000,1728562176
25001,1200000,925000,275000,1728529002,1728487658
25004,3000000,2202003,797997,1728528952,1728487670
25007,1090000,888000,202000,1728528975,1728487669
25010,2188000,1452000,736000,1728183248,1728487656
25013,1750000,1235000,515000,1728383449,1728493979
25016,148240,163434,-15194,1728557728,1728219788
25019,583051,60000,523051,1728365293,1728478308
25022,200000,300000,-100000,1728365487,1728218892
25025,132115,391321,-259206,1728164564,1728469321
25028,600000,55000,545000,1728508392,1728510064
25031,309000,100000,209000,1728363310,1728472961
25034,16562,16562,0,1728402060,1728472956
25037,19435,1000000,-980565,1728406620,1728428744
25056,124715,138187,-13472,1728522890,1728439815
25087,700000,600833,99167,1728561033,1728565956
25090,689500,615000,74500,1728563805,1728553116
25093,3999997,2521610,1478387,1728395377,1728469278
25096,2805855,2370000,435855,1728564355,1728487665
25099,220000,182017,37983,1728560783,1728563447
25139,800,755,45,1728562444,1728558386
25380,800000,2000000,-1200000,1728400424,1728403782
25383,2235000,2164599,70401,1728278386,1728214448
25386,6980000,6530000,450000,1728546650,1728271419
25389,87828,87005,823,1728563288,1728565572
25392,29994,17621,12373,1728550468,1728560192
25395,17511,23759,-6248,1728564234,1728565090
25398,33142,21000,12142,1728564802,1728562288
25401,74345,81965,-7620,1728563297,1728565023
25404,195000,188999,6001,1728565730,1728565773
25407,42463,35523,6940,1728565211,1728565255
25410,40813,39601,1212,1728564861,1728565736
25413,99900,97609,2291,1728565742,1728565668
25416,191500,183223,8277,1728565736,1728565589
25419,6920,6668,252,1728565988,1728565716
25442,911,909,2,1728440076,1728526243
25445,1308,1300,8,1727370054,1728565404
25448,990,1565,-575,1728521009,1728527380
25451,10781,10800,-19,1728457776,1728544552
25454,18100,18039,61,1728565033,1728563582
25478,2504,2583,-79,1728539971,1728564041
25481,5000,3556,1444,1728564863,1728565086
25521,449997,130000,319997,1728527236,1728534530
25524,83547,80382,3165,1728558054,1728539870
25576,671421,626443,44978,1728565515,1728565406
25578,2891,2783,108,1728565603,1728565512
25766,118,118,0,1728565469,1728565952
25769,302,250,52,1728565680,1728565997
25772,1188,1237,-49,1728564921,1728565936
25775,2358,2321,37,1728563063,1728565703
25778,4313,4206,107,1728564926,1728565956
25826,9999,500,9499,1728506347,1728483150
25833,451,440,11,1728556462,1728531076
25849,236,223,13,1728565995,1728565993
25851,549,222,327,1728561989,1728514484
25853,420,418,2,1728565332,1728565418
25855,702,315,387,1728510282,1728499101
25857,1204,1203,1,1728562257,1728562281
25859,160669158,158158013,2511145,1728564528,1728564864
25862,155368177,155088456,279721,1728565881,1728565441
25975,1958697,1927343,31354,1728565952,1728565814
25985,3750221,3716327,33894,1728565631,1728565976
26219,12723014,12566865,156149,1728565962,1728565978
26221,74990,59055,15935,1728565925,1728564278
26223,73639,47211,26428,1728564004,1728564899
26225,30797,28915,1882,1728565376,1728565556
26227,34098,23064,11034,1728543129,1728565782
26229,23178,23000,178,1728537557,1728565309
26231,4390,4391,-1,1728544793,1728565549
26233,36799999,36505000,294999,1728565707,1728565075
26235,101551678,100369090,1182588,1728565821,1728565187
26241,4339928,4239272,100656,1728565557,1728565800
26243,70742002,70750000,-7998,1728565540,1728565956
26245,39281313,39200000,81313,1728565529,1728565795
26247,,100000000,N/A,,1635032482
26266,10350000,10000000,350000,1728549563,1728346506
26340,2719,2600,119,1728565743,1728563165
26342,1872,1850,22,1728563243,1728565852
26344,1200,1200,0,1728501648,1728565851
26346,615,600,15,1728494046,1728553646
26350,1326,867,459,1727853649,1725754749
26353,693,40,653,1728412497,1727283634
26368,5347,4888,459,1728555000,1728555278
26370,35450000,35456788,-6788,1728516599,1728552981
26372,316000000,311634000,4366000,1728511890,1728558718
26374,371000000,368600000,2400000,1728565229,1728566001
26376,195000000,195888888,-888888,1728487242,1728559771
26378,345000000,344888888,111112,1728558635,1728561210
26380,262000000,260666666,1333334,1728506466,1728564856
26382,210769000,208200000,2569000,1728565268,1728564645
26384,370878321,366671836,4206485,1728564438,1728564642
26386,285900000,282487399,3412601,1728563366,1728565179
26390,61175,61000,175,1728565063,1728565587
26394,10649000,10211333,437667,1728563174,1728549584
26421,1375321,1209969,165352,1728561260,1728563960
26424,367250,28000,339250,1728284103,1728562018
26427,800000,261474,538526,1728562617,1728531420
26430,118110,5671,112439,1728542741,1728532872
26433,81650,25000,56650,1728542689,1728524470
26436,124364,7671,116693,1728542698,1728532854
26439,1870000,449000,1421000,1728205971,1728480102
26442,188218,208030,-19812,1728171833,1727556223
26445,166415,195782,-29367,1728483496,1727612058
26448,187818,197702,-9884,1728391579,1727867891
26451,2999000,2250000,749000,1728378321,1728522575
26454,1799000,1400000,399000,1728430004,1728522579
26457,969420,369420,600000,1728521352,1728504747
26460,1598000,650000,948000,1728505932,1728522573
26479,964987,920400,44587,1728564371,1728565648
26500,919000,854000,65000,1728563884,1728489142
26517,2387479,1852000,535479,1728533618,1728491139
26528,1042480,970018,72462,1728565772,1728564510
26541,92000,62845,29155,1728560586,1728551450
26554,100000,100,99900,1728524291,1728524331
26557,2000000,2088599,-88599,1728278347,1728204682
26560,7385000,6505123,879877,1728504545,1728514813
26788,30,28,2,1728548947,1728540703
26798,8998,7351,1647,1728557131,1728565815
26801,3499,1365,2134,1728563198,1728553831
26804,2616,11,2605,1728565145,1728541811
26815,1293741,1214134,79607,1728565756,1728565730
26945,2281529,2257847,23682,1728565575,1728565646
26997,4885,4831,54,1728565609,1728565946
27014,60000,58009,1991,1728565715,1728563378
27202,1540,1499,41,1728565821,1728564950
27205,1073,1101,-28,1728537764,1728565258
27208,776,505,271,1728512141,1728545541
27211,555,360,195,1728564392,1728565245
27226,6419310,6419310,0,1728565639,1728565639
27229,57725999,57111111,614888,1728565864,1728565744
27232,42034832,41555555,479277,1728565868,1728565741
27235,18303543,18000000,303543,1728564854,1728564651
27238,104921660,104514303,407357,1728564808,1728565108
27241,79179999,78095160,1084839,1728564750,1728565113
27269,12138475,11560891,577584,1728548310,1728548500
27272,2071,2049,22,1728565838,1728565963
27277,1147677376,1147677376,0,1728565844,1728565843
27355,202790000,202314899,475101,1728565930,1728562050
27612,83830407,83000000,830407,1728565919,1728565463
27614,16550000,16411115,138885,1728565972,1728565639
27616,11,10,1,1728565927,1728565849
27629,2058,2015,43,1728565978,1728565992
27632,1360,1300,60,1728565156,1728563172
27635,937,800,137,1728557436,1728563385
27638,949,421,528,1728562802,1728564678
27641,107147777,106500001,647776,1728565540,1728565353
27652,22545000,22244921,300079,1728565620,1728565992
27657,7340000,7249205,90795,1728565979,1728565949
27662,2631956,2635555,-3599,1728565785,1728565228
27667,75784,65156,10628,1728565428,1728565860
27670,48968,48112,856,1728565892,1728557454
27673,68236,67991,245,1728557217,1728565555
27676,2690000,2605000,85000,1728565426,1728562538
27681,23000000,22880969,119031,1728565089,1728565952
27684,11192565,11070000,122565,1728559548,1728561720
27687,45000000,46000004,-1000004,1728559377,1728564998
27690,82787769,81869376,918393,1728565890,1728565993
27785,2678000,2526000,152000,1728564315,1728561224
27897,602,602,0,1728563519,1728565927
28146,667813,645013,22800,1728565586,1728559093
28149,834216,691134,143082,1728564536,1728564786
28152,1848,1055,793,1728441254,1728508832
28154,31500,40000,-8500,1728209298,1728529095
28157,50,49,1,1728565689,1728564177
28159,5590,5336,254,1728534538,1728560666
28161,120,30,90,1728561762,1728561975
28163,3500000,2511000,989000,1728533653,1728357245
28166,4450000,2550000,1900000,1728496988,1728547978
28177,2444000,2444948,-948,1728565734,1728564439
28179,4729,4318,411,1707909607,1707909885
28181,25000,8500,16500,1707909599,1707909033
28184,10693,10693,0,1707910134,1707910134
28190,90000,95000,-5000,1707640188,1707879125
28193,15,50,-35,1728373385,1727114518
28196,1000000,1200000,-200000,1728348398,1728242363
28199,1500000,1250000,250000,1727553341,1727488909
28202,1494000,1106006,387994,1726195414,1726350747
28205,2649000,1500000,1149000,1728454353,1728364126
28208,2649000,1001001,1647999,1728510680,1728565930
28211,1999995,1705555,294440,1728527018,1728565941
28214,2531398,2391000,140398,1728561369,1728565945
28217,2591107,2591107,0,1728565926,1728565824
28226,2147483647,2147483647,0,1713795324,1706749421
28276,105272,85503,19769,1728564967,1728565940
28295,4899000,4315000,584000,1728562373,1728531857
28298,3433333,2500000,933333,1728522601,1728424094
28301,100000,88944,11056,1728547608,1728562110
28304,493475,370000,123475,1728551714,1728389880
28307,188895000,187111111,1783889,1728565160,1728565434
28310,74580000,73435000,1145000,1728565928,1728565479
28313,59000000,58663563,336437,1728565793,1728563689
28316,43234234,42341996,892238,1728565412,1728565770
28334,945000,941000,4000,1728564596,1728565857
28338,415999995,414800000,1199995,1728565884,1728565040
28583,95000,87600,7400,1728564345,1728564851
28628,3700,3700,0,1728537535,1728564981
28644,80000,81050,-1050,1707542877,1707874556
28646,10846,9985,861,1707909288,1707910163
28651,80000,45000,35000,1707623824,1707831455
28653,15000,6000,9000,1707909672,1707910008
28657,6997,6997,0,1707909822,1707909548
28659,70000,45000,25000,1707909697,1707890757
28665,10963,9000,1963,1707909712,1707910098
28667,100000,101000,-1000,1707909368,1707909706
28684,7150000,6602000,548000,1728556399,1728565401
28690,5348999,4894555,454444,1728559961,1728565747
28693,1750000,1800000,-50000,1728564191,1728517235
28696,6000000,6095213,-95213,1728561653,1728542471
28699,3449999,2757394,692605,1728562610,1728565599
28702,498995,220000,278995,1728420698,1728504880
28705,764235,813236,-49001,1728560909,1728467115
28708,8250000,7975001,274999,1728551231,1728565786
28712,100000,20000,80000,1728465883,1728533005
28715,50000,10000,40000,1728556263,1728549609
28718,84969,8671,76298,1728336086,1728489508
28721,69000,25000,44000,1728454024,1728489440
28724,195756,3000,192756,1728506608,1728404036
28727,180000,54000,126000,1728547775,1728438424
28730,598000,73420,524580,1728525840,1728352104
28733,150000,80300,69700,1728496403,1728532414
28736,1000000,880636,119364,1728463724,1728562979
28739,2799997,2153643,646354,1728562770,1728487924
28742,2489000,1014589,1474411,1728385396,1728516189
28745,899999,369478,530521,1728538021,1728487910
28748,1500000,1245356,254644,1728467000,1728487902
28777,374998,16444,358554,1728529432,1728563691
28780,2240000,1927532,312468,1728337413,1728345896
28783,7400000,6812222,587778,1728509228,1728509386
28790,760,650,110,1728565063,1728554993
28810,2537000,2456925,80075,1728565418,1728565160
28813,2579000,2217206,361794,1728520725,1728563704
28824,1072,1063,9,1728565976,1728565314
28831,159,978,-819,1728540985,1728563707
28834,285000,275009,9991,1728563540,1728565706
28837,15,7,8,1728565035,1728565709
28869,7992,6282,1710,1728565747,1728565732
28872,248,227,21,1728565465,1728565697
28878,542,537,5,1728565670,1728565760
28890,99,80,19,1728561729,1728561736
28893,643,639,4,1728565358,1728563713
28896,120,500,-380,1728547079,1728524492
28899,542,548,-6,1728564844,1728565927
28919,94927774,93627003,1300771,1728565317,1728564594
28924,626,622,4,1728565904,1728565754
28929,111,108,3,1728565416,1728565421
28931,13729,12804,925,1728565777,1728564918
28933,530000,481033,48967,1728563809,1728565734
28936,6389777,6145339,244438,1728565847,1728564909
28939,12221997,12033333,188664,1728565838,1728565567
28942,4500000,4571788,-71788,1728563704,1728564856
28988,696622,733286,-36664,1728565267,1728565110
28991,136,135,1,1728565752,1728565878
28997,12857106,12463502,393604,1728565698,1728565365
29000,2749643,2741100,8543,1728565532,1728565416
29004,958755,955000,3755,1728564551,1728564783
29007,995000,966353,28647,1728564558,1728564789
29010,838101,825000,13101,1728564546,1728565356
29013,2131065,2094536,36529,1728565407,1728565052
29016,5625613,5500000,125613,1728564843,1728565953
29019,619777,606800,12977,1728563123,1728564986
29022,7650000,7574928,75072,1728565913,1728565829
29025,15800000,15789336,10664,1728565619,1728565192
29028,3800000,3715000,85000,1728565574,1728565511
29049,202912,200000,2912,1728491919,1728564615
29052,201919,200888,1031,1728491932,1728564579
29055,71555,72000,-445,1728501641,1728564577
29058,1201251,1103888,97363,1728560966,1728561095
29061,6055722,6200000,-144278,1728525681,1728544926
29064,133527,115103,18424,1728560955,1728561083
29067,6400000,6660001,-260001,1728430392,1728565268
29070,11200000,14060000,-2860000,1727848338,1728565370
29073,3100000,2505000,595000,1728542099,1728565216
29084,25000,21657,3343,1728565967,1728565520
29090,7000,6918,82,1728565770,1728565278
29098,340,13,327,1710944952,1710945430
29101,699,750,-51,1728510700,1728556513
29104,3000,1438,1562,1728509268,1728565650
29107,1091,901,190,1728559219,1728564626
29110,249,225,24,1728563892,1728565545
29113,3150,3150,0,1728558482,1728565551
29116,440,440,0,1728565450,1728565902
29119,223,432,-209,1728539649,1728565995
29122,1000,350,650,1728553467,1728565889
29125,300,250,50,1728558723,1728565993
29128,434,200,234,1728350412,1728401020
29131,95,20,75,1728345544,1728521533
29134,1485,1321,164,1728563010,1728527688
29137,404,386,18,1728562474,1728559716
29140,695,692,3,1728563389,1728551157
29143,3720,3626,94,1728565968,1728560772
29146,5,50,-45,1728521934,1728523790
29149,104,130,-26,1728552676,1728344538
29152,232,232,0,1728565926,1728565984
29163,622,622,0,1728564269,1728564298
29166,183,158,25,1728565596,1728565974
29168,3500,2501,999,1728563228,1728564602
29171,6750,5053,1697,1728563372,1728564363
29174,619,619,0,1728565304,1728556566
29177,143,143,0,1728565999,1728564620
29180,621,2772,-2151,1727504548,1728388257
29183,2525,1030,1495,1728495499,1728524857
29186,500,809,-309,1727392024,1728448240
29189,398,1575,-1177,1728522668,1728541656
29192,1650,1341,309,1728564339,1728562150
29195,2440,2436,4,1728565143,1728564332
29198,50,50,0,1723786860,1723675711
29201,204,110,94,1727130954,1723996609
29204,686,50,636,1726991315,1724176803
29207,475,100,375,1727947716,1728290550
29210,700,1000,-300,1728520499,1728562071
29213,1800,1500,300,1728500076,1728558764
29218,2100,2100,0,1728564375,1728554762
29253,3416,2700,716,1728563962,1728563615
29256,22977,6404,16573,1728564044,1728563284
29277,450,300,150,1728540499,1728564613
29280,16263,14300,1963,1728565924,1728565918
29283,21900,21436,464,1728565930,1728565636
29286,14943,14099,844,1728565931,1728565844
29289,13634,13544,90,1728565895,1728565924
29292,15800,14001,1799,1728522006,1728549348
29305,450,293,157,1728564206,1728556829
29307,15000,13236,1764,1728565768,1728565925
29311,4,3,1,1728561999,1728565539
29409,3000,77,2923,1728432538,1728550488
29412,9999,103,9896,1728542990,1728540192
29415,748,1138,-390,1728503544,1728510898
29418,100000,99,99901,1728393004,1728513135
29421,301,200,101,1728495735,1728528487
29424,19000000,18875323,124677,1728564712,1728551435
29449,21815,21112,703,1728565927,1728565600
29455,2405080,2302005,103075,1728565720,1728565686
29458,234,212,22,1728565122,1728565873
29486,15095,15030,65,1728563940,1728565271
29574,10700000,10555555,144445,1728557319,1728564864
29577,21499999,21222888,277111,1728565890,1728565722
29580,52000000,52037688,-37688,1728565966,1728565858
29619,15995000,15800006,194994,1728560878,1728559724
29622,47500000,46166752,1333248,1728517554,1728487227
29625,64992997,61518518,3474479,1728552978,1728553176
29628,33000000,31043666,1956334,1728564741,1728553164
29684,6160,6030,130,1728565996,1728565382
29782,27000,26555,445,1728565731,1728565841
29784,900,905,-5,1728565557,1728565964
29796,20129848,19881000,248848,1728565967,1728565772
29801,98367000,97096344,1270656,1728565973,1728565886
29806,11887241,11672419,214822,1728565682,1728565848
29824,17432,17100,332,1728565980,1728565707
29827,12839,11230,1609,1728565847,1728562033
29830,7453,7500,-47,1728561115,1728564149
29833,4194,3827,367,1728565127,1728562146
29889,153500,150000,3500,1728565953,1728565862
29895,130,130,0,1728565413,1728565441
29900,100,77,23,1728544233,1728559617
29944,224,100,124,1728506989,1728517069
29947,3000,2000,1000,1728533072,1728486044
29952,100,1000,-900,1728510905,1728327910
29955,371,610,-239,1728555838,1728443601
29958,600,600,0,1728535831,1728535859
29963,12353,156,12197,1728476975,1728550756
29966,1,400,-399,1728509549,1728528464
29993,101000,101000,0,1728565873,1728565872
30002,20599987,19631000,968987,1728565678,1728565570
30040,35000,32113,2887,1728564348,1728564653
30066,700000,607754,92246,1728562274,1728565137
30068,2120,2001,119,1728564864,1728565784
30070,29613418,28850016,763402,1728565315,1728565541
30073,5800000,5200000,600000,1728565111,1728563589
30076,8199997,8177182,22815,1728565013,1728563728
30079,5821962,5030380,791582,1728565026,1728563762
30082,2849000,2700000,149000,1728565121,1728564087
30085,2900000,2850000,50000,1728563046,1728565812
30088,27801,27250,551,1728565553,1728565222
30094,6981,6800,181,1728565846,1728564350
30097,5000,4400,600,1728564509,1728565790
30100,7000,5252,1748,1728564330,1728564338
30125,119800,119000,800,1728565927,1728565559
30128,89999,83967,6032,1728563973,1728563981
30131,65161,80000,-14839,1728565920,1728561961
30134,35000,27000,8000,1728565719,1728549831
30137,120000,110116,9884,1728565969,1728565265
30140,85000,81000,4000,1728564981,1728564958
30143,65161,46000,19161,1728565723,1728557161
30146,29000,24750,4250,1728565854,1728565231
